|🌑,🌑,🌑,🌑,🌑,🌑,🌑,🌑,🌑,🌑,🌑,🌑,🌑,🌑,🌑,🌑,🌑,🌑,🌑,🌑,🌑,🌑,🌑,🌑,🌑,🌑,🌑,🌑,🌑,🌑,🌑,🌑,🌑,🌑,🌑,🌑,🌑,🌑,🌑,🌑
|🌑,🌑,🌑,🌑,🌑,🌑,🌑,🌑,🌑,🌑,🌑,🌑,🌑,🌑,🌑,🌑,🌑,🌑,🌑,🌑,🌑,🌑,🌑,🌑,🌑,🌑,🌑,🌑,🌑,🌑,🌑,🌑,🌑,🌑,🌑,🌑,🌑,🌑,🌑,🌑
|🌑,🌑,🌑,🌑,🌑,🌑,🌑,🌑,🌑,🌑,🌑,🌑,🌑,🌑,🌑,🌑,🌑,🌑,🌑,🌑,🌑,🌑,🌑,🌑,🌑,🌑,🌑,🌑,🌑,🌑,🌑,🌑,🌑,🌑,🌑,🌑,🌑,🌑,🌑,🌑
|🌑,🌑,🌑,🌑,🌑,🌑,🌑,🌑,🌑,🌑,🌑,🌑,🌑,🌑,🌑,🌑,🌑,🌑,🌑,🌑,🌑,🌑,🌑,🌑,🌑,🌑,🌑,🌑,🌑,🌑,🌑,🌑,🌑,🌑,🌑,🌑,🌑,🌑,🌑,🌑
|🌑,🌑,🌑,🌑,🌑,🌑,🌑,🌑,🌑,🌑,🌑,🌑,🌑,🌑,🌑,🌑,🌑,🌑,🌑,🌑,🌑,🌑,🌑,🌑,🌑,🌑,🌑,🌑,🌑,🌑,🌑,🌑,🌑,🌑,🌑,🌑,🌑,🌑,🌑,🌑
|🌑,🌑,🌑,🌑,🌑,🌑,🌑,🌑,🌑,🌑,🌑,🌑,🌑,🌑,🌑,🌑,🌑,🌑,🌑,🌑,🌑,🌑,🌑,🌑,🌑,🌑,🌑,🌑,🌑,🌑,🌑,🌑,🌑,🌑,🌑,🌑,🌑,🌑,🌑,🌑
|🌑,🌑,🌑,🌑,🌑,🌑,🌑,🌑,🌑,🌑,🌑,🌑,🌑,🌑,🌑,🌑,🌑,🌑,🌑,🌑,🌑,🌑,🌑,🌑,🌑,🌑,🌑,🌑,🌑,🌑,🌑,🌑,🌑,🌑,🌑,🌑,🌑,🌑,🌑,🌑
|🌑,🌑,🌑,🌑,🌑,🌑,🌑,🌑,🌑,🌑,🌑,🌑,🌑,🌑,🌑,🌑,🌑,🌑,🌑,🌑,🌑,🌑,🌑,🌑,🌑,🌑,🌑,🌑,🌑,🌑,🌑,🌑,🌑,🌑,🌑,🌑,🌑,🌑,🌑,🌑
|🌑,🌑,🌑,🌑,🌑,🌑,🌑,🌑,🌑,🌑,🌑,🌑,🌑,🌑,🌑,🌑,🌑,🌑,🌑,🌑,🌑,🌑,🌑,🌑,🌑,🌑,🌑,🌑,🌑,🌑,🌑,🌑,🌑,🌑,🌑,🌑,🌑,🌑,🌑,🌑
|🌑,🌑,🌑,🌑,🌑,🌑,🌑,🌑,🌑,🌑,🌑,🌑,🌑,🌑,🌑,🌑,🌑,🌑,🌑,🌑,🌑,🌑,🌑,🌑,🌑,🌑,🌑,🌑,🌑,🌑,🌑,🌑,🌑,🌑,🌑,🌑,🌑,🌑,🌑,🌑
|🌑,🌑,🌑,🌑,🌑,🌑,🌑,🌑,🌑,🌑,🌑,🌑,🌑,🌑,🌑,🌑,🌑,🌑,🌑,🌑,🌑,🌑,🌑,🌑,🌑,🌑,🌑,🌑,🌑,🌑,🌑,🌑,🌑,🌑,🌑,🌑,🌑,🌑,🌑,🌑
|🌑,🌑,🌑,🌑,🌑,🌑,🌑,🌑,🌑,🌑,🌑,🌑,🌑,🌑,🌑,🌑,🌑,🌑,🌑,🌑,🌑,🌑,🌑,🌑,🌑,🌑,🌑,🌑,🌑,🌑,🌑,🌑,🌑,🌑,🌑,🌑,🌑,🌑,🌑,🌑
|🌑,🌑,🌑,🌑,🌑,🌑,🌑,🌑,🌑,🌑,🌑,🌑,🌑,🌑,🌑,🌑,🌑,🌑,🌑,🌑,🌑,🌑,🌑,🌑,🌑,🌑,🌑,🌑,🌑,🌑,🌑,🌑,🌑,🌑,🌑,🌑,🌑,🌑,🌑,🌑
|🌑,🌑,🌑,🌑,🌑,🌑,🌑,🌑,🌑,🌑,🌑,🌑,🌑,🌑,🌑,🌑,🌑,🌑,🌑,🌑,🌑,🌑,🌑,🌑,🌑,🌑,🌑,🌑,🌑,🌑,🌑,🌑,🌑,🌑,🌑,🌑,🌑,🌑,🌑,🌑
|🌑,🌑,🌑,🌑,🌑,🌑,🌑,🌑,🌑,🌑,🌑,🌑,🌑,🌑,🌑,🌑,🌑,🌑,🌑,🌑,🌑,🌑,🌑,🌑,🌑,🌑,🌑,🌑,🌑,🌑,🌑,🌑,🌑,🌑,🌑,🌑,🌑,🌑,🌑,🌑
|🌑,🌑,🌑,🌑,🌑,🌑,🌑,🌑,🌑,🌑,🌑,🌑,🌑,🌑,🌑,🌑,🌑,🌑,🌑,🌑,🌑,🌑,🌑,🌑,🌑,🌑,🌑,🌑,🌑,🌑,🌑,🌑,🌑,🌑,🌑,🌑,🌑,🌑,🌑,🌑
|🌑,🌑,🌑,🌑,🌑,🌑,🌑,🌑,🌑,🌑,🌑,🌑,🌑,🌑,🌑,🌑,🌑,🌑,🌑,🌑,🌑,🌑,🌑,🌑,🌑,🌑,🌑,🌑,🌑,🌑,🌑,🌑,🌑,🌑,🌑,🌑,🌑,🌑,🌑,🌑
|🌑,🌑,🌑,🌑,🌑,🌑,🌑,🌑,🌑,🌑,🌑,🌑,🌑,🌑,🌑,🌑,🌑,🌑,🌑,🌑,🌑,🌑,🌑,🌑,🌑,🌑,🌑,🌑,🌑,🌑,🌑,🌑,🌑,🌑,🌑,🌑,🌑,🌑,🌑,🌑
|🌑,🌑,🌑,🌑,🌑,🌑,🌑,🌑,🌑,🌑,🌑,🌑,🌑,🌑,🌑,🌑,🌑,🌑,🌑,🌑,🌑,🌑,🌑,🌑,🌑,🌑,🌑,🌑,🌑,🌑,🌑,🌑,🌑,🌑,🌑,🌑,🌑,🌑,🌑,🌑
|🌑,🌑,🌑,🌑,🌑,🌑,🌑,🌑,🌑,🌑,🌑,🌑,🌑,🌑,🌑,🌑,🌑,🌑,🌑,🌑,🌑,🌑,🌑,🌑,🌑,🌑,🌑,🌑,🌑,🌑,🌑,🌑,🌑,🌑,🌑,🌑,🌑,🌑,🌑,🌑
|🌑,🌑,🌑,🌑,🌑,🌑,🌑,🌑,🌑,🌑,🌑,🌑,🌑,🌑,🌑,🌑,🌑,🌑,🌑,🌑,🌑,🌑,🌑,🌑,🌑,🌑,🌑,🌑,🌑,🌑,🌑,🌑,🌑,🌑,🌑,🌑,🌑,🌑,🌑,🌑
|🌑,🌑,🌑,🌑,🌑,🌑,🌑,🌑,🌑,🌑,🌑,🌑,🌑,🌑,🌑,🌑,🌑,🌑,🌑,🌑,🌑,🌑,🌑,🌑,🌑,🌑,🌑,🌑,🌑,🌑,🌑,🌑,🌑,🌑,🌑,🌑,🌑,🌑,🌑,🌑
|🌑,🌑,🌑,🌑,🌑,🌑,🌑,🌑,🌑,🌑,🌑,🌑,🌑,🌑,🌑,🌑,🌑,🌑,🌑,🌑,🌑,🌑,🌑,🌑,🌑,🌑,🌑,🌑,🌑,🌑,🌑,🌑,🌑,🌑,🌑,🌑,🌑,🌑,🌑,🌑
|🌑,🌑,🌑,🌑,🌑,🌑,🌑,🌑,🌑,🌑,🌑,🌑,🌑,🌑,🌑,🌑,🌑,🌑,🌑,🌑,🌑,🌑,🌑,🌑,🌑,🌑,🌑,🌑,🌑,🌑,🌑,🌑,🌑,🌑,🌑,🌑,🌑,🌑,🌑,🌑
|🌑,🌑,🌑,🌑,🌑,🌑,🌑,🌑,🌑,🌑,🌑,🌑,🌑,🌑,🌑,🌑,🌑,🌑,🌑,🌑,🌑,🌑,🌑,🌑,🌑,🌑,🌑,🌑,🌑,🌑,🌑,🌑,🌑,🌑,🌑,🌑,🌑,🌑,🌑,🌑
|🌑,🌑,🌑,🌑,🌑,🌑,🌑,🌑,🌑,🌑,🌑,🌑,🌑,🌑,🌑,🌑,🌑,🌑,🌑,🌑,🌑,🌑,🌑,🌑,🌑,🌑,🌑,🌑,🌑,🌑,🌑,🌑,🌑,🌑,🌑,🌑,🌑,🌑,🌑,🌑
|🌑,🌑,🌑,🌑,🌑,🌑,🌑,🌑,🌑,🌑,🌑,🌑,🌑,🌑,🌑,🌑,🌑,🌑,🌑,🌑,🌑,🌑,🌑,🌑,🌑,🌑,🌑,🌑,🌑,🌑,🌑,🌑,🌑,🌑,🌑,🌑,🌑,🌑,🌑,🌑
|🌑,🌑,🌑,🌑,🌑,🌑,🌑,🌑,🌑,🌑,🌑,🌑,🌑,🌑,🌑,🌑,🌑,🌑,🌑,🌑,🌑,🌑,🌑,🌑,🌑,🌑,🌑,🌑,🌑,🌑,🌑,🌑,🌑,🌑,🌑,🌑,🌑,🌑,🌑,🌑
|🌑,🌑,🌑,🌑,🌑,🌑,🌑,🌑,🌑,🌑,🌑,🌑,🌑,🌑,🌑,🌑,🌑,🌑,🌑,🌑,🌑,🌑,🌑,🌑,🌑,🌑,🌑,🌑,🌑,🌑,🌑,🌑,🌑,🌑,🌑,🌑,🌑,🌑,🌑,🌑
|🌑,🌑,🌑,🌑,🌑,🌑,🌑,🌑,🌑,🌑,🌑,🌑,🌑,🌑,🌑,🌑,🌑,🌑,🌑,🌑,🌑,🌑,🌑,🌑,🌑,🌑,🌑,🌑,🌑,🌑,🌑,🌑,🌑,🌑,🌑,🌑,🌑,🌑,🌑,🌑
|🌑,🌑,🌑,🌑,🌑,🌑,🌑,🌑,🌑,🌑,🌑,🌑,🌑,🌑,🌑,🌑,🌑,🌑,🌑,🌑,🌑,🌑,🌑,🌑,🌑,🌑,🌑,🌑,🌑,🌑,🌑,🌑,🌑,🌑,🌑,🌑,🌑,🌑,🌑,🌑
|🌑,🌑,🌑,🌑,🌑,🌑,🌑,🌑,🌑,🌑,🌑,🌑,🌑,🌑,🌑,🌑,🌑,🌑,🌑,🌑,🌑,🌑,🌑,🌑,🌑,🌑,🌑,🌑,🌑,🌑,🌑,🌑,🌑,🌑,🌑,🌑,🌑,🌑,🌑,🌑
|🌑,🌑,🌑,🌑,🌑,🌑,🌑,🌑,🌑,🌑,🌑,🌑,🌑,🌑,🌑,🌑,🌑,🌑,🌑,🌑,🌑,🌑,🌑,🌑,🌑,🌑,🌑,🌑,🌑,🌑,🌑,🌑,🌑,🌑,🌑,🌑,🌑,🌑,🌑,🌑
|🌑,🌑,🌑,🌑,🌑,🌑,🌑,🌑,🌑,🌑,🌑,🌑,🌑,🌑,🌑,🌑,🌑,🌑,🌑,🌑,🌑,🌑,🌑,🌑,🌑,🌑,🌑,🌑,🌑,🌑,🌑,🌑,🌑,🌑,🌑,🌑,🌑,🌑,🌑,🌑
|🌑,🌑,🌑,🌑,🌑,🌑,🌑,🌑,🌑,🌑,🌑,🌑,🌑,🌑,🌑,🌑,🌑,🌑,🌑,🌑,🌑,🌑,🌑,🌑,🌑,🌑,🌑,🌑,🌑,🌑,🌑,🌑,🌑,🌑,🌑,🌑,🌑,🌑,🌑,🌑
|🌑,🌑,🌑,🌑,🌑,🌑,🌑,🌑,🌑,🌑,🌑,🌑,🌑,🌑,🌑,🌑,🌑,🌑,🌑,🌑,🌑,🌑,🌑,🌑,🌑,🌑,🌑,🌑,🌑,🌑,🌑,🌑,🌑,🌑,🌑,🌑,🌑,🌑,🌑,🌑
|🌑,🌑,🌑,🌑,🌑,🌑,🌑,🌑,🌑,🌑,🌑,🌑,🌑,🌑,🌑,🌑,🌑,🌑,🌑,🌑,🌑,🌑,🌑,🌑,🌑,🌑,🌑,🌑,🌑,🌑,🌑,🌑,🌑,🌑,🌑,🌑,🌑,🌑,🌑,🌑
|🌑,🌑,🌑,🌑,🌑,🌑,🌑,🌑,🌑,🌑,🌑,🌑,🌑,🌑,🌑,🌑,🌑,🌑,🌑,🌑,🌑,🌑,🌑,🌑,🌑,🌑,🌑,🌑,🌑,🌑,🌑,🌑,🌑,🌑,🌑,🌑,🌑,🌑,🌑,🌑
|🌑,🌑,🌑,🌑,🌑,🌑,🌑,🌑,🌑,🌑,🌑,🌑,🌑,🌑,🌑,🌑,🌑,🌑,🌑,🌑,🌑,🌑,🌑,🌑,🌑,🌑,🌑,🌑,🌑,🌑,🌑,🌑,🌑,🌑,🌑,🌑,🌑,🌑,🌑,🌑
|🌑,🌑,🌑,🌑,🌑,🌑,🌑,🌑,🌑,🌑,🌑,🌑,🌑,🌑,🌑,🌑,🌑,🌑,🌑,🌑,🌑,🌑,🌑,🌑,🌑,🌑,🌑,🌑,🌑,🌑,🌑,🌑,🌑,🌑,🌑,🌑,🌑,🌑,🌑,🌑
|🌑,🌑,🌑,🌑,🌑,🌑,🌑,🌑,🌑,🌑,🌑,🌑,🌑,🌑,🌑,🌑,🌑,🌑,🌑,🌑,🌑,🌑,🌑,🌑,🌑,🌑,🌑,🌑,🌑,🌑,🌑,🌑,🌑,🌑,🌑,🌑,🌑,🌑,🌑,🌑
|🌑,🌑,🌑,🌑,🌑,🌑,🌑,🌑,🌑,🌑,🌑,🌑,🌑,🌑,🌑,🌑,🌑,🌑,🌑,🌑,🌑,🌑,🌑,🌑,🌑,🌑,🌑,🌑,🌑,🌑,🌑,🌑,🌑,🌑,🌑,🌑,🌑,🌑,🌑,🌑
|🌑,🌑,🌑,🌑,🌑,🌑,🌑,🌑,🌑,🌑,🌑,🌑,🌑,🌑,🌑,🌑,🌑,🌑,🌑,🌑,🌑,🌑,🌑,🌑,🌑,🌑,🌑,🌑,🌑,🌑,🌑,🌑,🌑,🌑,🌑,🌑,🌑,🌑,🌑,🌑
|🌑,🌑,🌑,🌑,🌑,🌑,🌑,🌑,🌑,🌑,🌑,🌑,🌑,🌑,🌑,🌑,🌑,🌑,🌑,🌑,🌑,🌑,🌑,🌑,🌑,🌑,🌑,🌑,🌑,🌑,🌑,🌑,🌑,🌑,🌑,🌑,🌑,🌑,🌑,🌑
|🌑,🌑,🌑,🌑,🌑,🌑,🌑,🌑,🌑,🌑,🌑,🌑,🌑,🌑,🌑,🌑,🌑,🌑,🌑,🌑,🌑,🌑,🌑,🌑,🌑,🌑,🌑,🌑,🌑,🌑,🌑,🌑,🌑,🌑,🌑,🌑,🌑,🌑,🌑,🌑
|🌑,🌑,🌑,🌑,🌑,🌑,🌑,🌑,🌑,🌑,🌑,🌑,🌑,🌑,🌑,🌑,🌑,🌑,🌑,🌑,🌑,🌑,🌑,🌑,🌑,🌑,🌑,🌑,🌑,🌑,🌑,🌑,🌑,🌑,🌑,🌑,🌑,🌑,🌑,🌑
|✳️,🌑,🌑,🌑,🌑,🌑,🌑,🌑,🌑,🌑,🌑,🌑,🌑,🌑,🌑,🌑,🌑,🌑,🌑,✳️,🌑,🌑,🌑,🌑,🌑,🌑,🌑,🌑,🌑,🌑,🌑,🌑,🌑,🌑,🌑,🌑,🌑,🌑,🌑,✳️
|🌑,🌑,🌑,🌑,🌑,🌑,🌑,🌑,🌑,🌑,🌑,🌑,🌑,🌑,🌑,🌑,🌑,🌑,🌑,🌑,🌑,🌑,🌑,🌑,🌑,🌑,🌑,🌑,🌑,🌑,🌑,🌑,🌑,🌑,🌑,🌑,🌑,🌑,🌑,🌑
|🌑,🌑,🌑,🌑,🌑,🌑,🌑,🌑,🌑,🌑,🌑,🌑,🌑,🌑,🌑,🌑,🌑,🌑,🌑,🌑,🌑,🌑,🌑,🌑,🌑,🌑,🌑,🌑,🌑,🌑,🌑,🌑,🌑,🌑,🌑,🌑,🌑,🌑,🌑,🌑
|🌑,🌑,🌑,🌑,🌑,🌑,🌑,🌑,🌑,🌑,🌑,🌑,🌑,🌑,🌑,🌑,🌑,🌑,🌑,🌑,🌑,🌑,🌑,🌑,🌑,🌑,🌑,🌑,🌑,🌑,🌑,🌑,🌑,🌑,🌑,🌑,🌑,🌑,🌑,🌑
|🌑,🌑,🌑,🌑,🌑,🌑,🌑,🌑,🌑,🌑,🌑,🌑,🌑,🌑,🌑,🌑,🌑,🌑,🌑,🌑,🌑,🌑,🌑,🌑,🌑,🌑,🌑,🌑,🌑,🌑,🌑,🌑,🌑,🌑,🌑,🌑,🌑,🌑,🌑,🌑
|🌑,🌑,🌑,🌑,🌑,🌑,🌑,🌑,🌑,🌑,🌑,🌑,🌑,🌑,🌑,🌑,🌑,🌑,🌑,🌑,🌑,🌑,🌑,🌑,🌑,🌑,🌑,🌑,🌑,🌑,🌑,🌑,🌑,🌑,🌑,🌑,🌑,🌑,🌑,🌑
|🌑,🌑,🌑,🌑,🌑,🌑,🌑,🌑,🌑,🌑,🌑,🌑,🌑,🌑,🌑,🌑,🌑,🌑,🌑,🌑,🌑,🌑,🌑,🌑,🌑,🌑,🌑,🌑,🌑,🌑,🌑,🌑,🌑,🌑,🌑,🌑,🌑,🌑,🌑,🌑
|🌑,🌑,🌑,🌑,🌑,🌑,🌑,🌑,🌑,🌑,🌑,🌑,🌑,🌑,🌑,🌑,🌑,🌑,🌑,🌑,🌑,🌑,🌑,🌑,🌑,🌑,🌑,🌑,🌑,🌑,🌑,🌑,🌑,🌑,🌑,🌑,🌑,🌑,🌑,🌑
|🌑,🌑,🌑,🌑,🌑,🌑,🌑,🌑,🌑,🌑,🌑,🌑,🌑,🌑,🌑,🌑,🌑,🌑,🌑,🌑,🌑,🌑,🌑,🌑,🌑,🌑,🌑,🌑,🌑,🌑,🌑,🌑,🌑,🌑,🌑,🌑,🌑,🌑,🌑,🌑
|🌑,🌑,🌑,🌑,🌑,🌑,🌑,🌑,🌑,🌑,🌑,🌑,🌑,🌑,🌑,🌑,🌑,🌑,🌑,🌑,🌑,🌑,🌑,🌑,🌑,🌑,🌑,🌑,🌑,🌑,🌑,🌑,🌑,🌑,🌑,🌑,🌑,🌑,🌑,🌑
|🌑,🌑,🌑,🌑,🌑,🌑,🌑,🌑,🌑,🌑,🌑,🌑,🌑,🌑,🌑,🌑,🌑,🌑,🌑,🌑,🌑,🌑,🌑,🌑,🌑,🌑,🌑,🌑,🌑,🌑,🌑,🌑,🌑,🌑,🌑,🌑,🌑,🌑,🌑,🌑
|🌑,🌑,🌑,🌑,🌑,🌑,🌑,🌑,🌑,🌑,🌑,🌑,🌑,🌑,🌑,🌑,🌑,🌑,🌑,🌑,🌑,🌑,🌑,🌑,🌑,🌑,🌑,🌑,🌑,🌑,🌑,🌑,🌑,🌑,🌑,🌑,🌑,🌑,🌑,🌑
|🌑,🌑,🌑,🌑,🌑,🌑,🌑,🌑,🌑,🌑,🌑,🌑,🌑,🌑,🌑,🌑,🌑,🌑,🌑,🌑,🌑,🌑,🌑,🌑,🌑,🌑,🌑,🌑,🌑,🌑,🌑,🌑,🌑,🌑,🌑,🌑,🌑,🌑,🌑,🌑
|🌑,🌑,🌑,🌑,🌑,🌑,🌑,🌑,🌑,🌑,🌑,🌑,🌑,🌑,🌑,🌑,🌑,🌑,🌑,🌑,🌑,🌑,🌑,🌑,🌑,🌑,🌑,🌑,🌑,🌑,🌑,🌑,🌑,🌑,🌑,🌑,🌑,🌑,🌑,🌑
|🌑,🌑,🌑,🌑,🌑,🌑,🌑,🌑,🌑,🌑,🌑,🌑,🌑,🌑,🌑,🌑,🌑,🌑,🌑,🌑,🌑,🌑,🌑,🌑,🌑,🌑,🌑,🌑,🌑,🌑,🌑,🌑,🌑,🌑,🌑,🌑,🌑,🌑,🌑,🌑
|🌑,🌑,🌑,🌑,🌑,🌑,🌑,🌑,🌑,🌑,🌑,🌑,🌑,🌑,🌑,🌑,🌑,🌑,🌑,🌑,🌑,🌑,🌑,🌑,🌑,🌑,🌑,🌑,🌑,🌑,🌑,🌑,🌑,🌑,🌑,🌑,🌑,🌑,🌑,🌑
|🌑,🌑,🌑,🌑,🌑,🌑,🌑,🌑,🌑,🌑,🌑,🌑,🌑,🌑,🌑,🌑,🌑,🌑,🌑,🌑,🌑,🌑,🌑,🌑,🌑,🌑,🌑,🌑,🌑,🌑,🌑,🌑,🌑,🌑,🌑,🌑,🌑,🌑,🌑,🌑
|🌑,🌑,🌑,🌑,🌑,🌑,🌑,🌑,🌑,🌑,🌑,🌑,🌑,🌑,🌑,🌑,🌑,🌑,🌑,🌑,🌑,🌑,🌑,🌑,🌑,🌑,🌑,🌑,🌑,🌑,🌑,🌑,🌑,🌑,🌑,🌑,🌑,🌑,🌑,🌑
|🌑,🌑,🌑,🌑,🌑,🌑,🌑,🌑,🌑,🌑,🌑,🌑,🌑,🌑,🌑,🌑,🌑,🌑,🌑,🌑,🌑,🌑,🌑,🌑,🌑,🌑,🌑,🌑,🌑,🌑,🌑,🌑,🌑,🌑,🌑,🌑,🌑,🌑,🌑,🌑
|🌑,🌑,🌑,🌑,🌑,🌑,🌑,🌑,🌑,🌑,🌑,🌑,🌑,🌑,🌑,🌑,🌑,🌑,🌑,🌑,🌑,🌑,🌑,🌑,🌑,🌑,🌑,🌑,🌑,🌑,🌑,🌑,🌑,🌑,🌑,🌑,🌑,🌑,🌑,🌑
|🌑,🌑,🌑,🌑,🌑,🌑,🌑,🌑,🌑,🌑,🌑,🌑,🌑,🌑,🌑,🌑,🌑,🌑,🌑,🌑,🌑,🌑,🌑,🌑,🌑,🌑,🌑,🌑,🌑,🌑,🌑,🌑,🌑,🌑,🌑,🌑,🌑,🌑,🌑,🌑
|🌑,🌑,🌑,🌑,🌑,🌑,🌑,🌑,🌑,🌑,🌑,🌑,🌑,🌑,🌑,🌑,🌑,🌑,🌑,🌑,🌑,🌑,🌑,🌑,🌑,🌑,🌑,🌑,🌑,🌑,🌑,🌑,🌑,🌑,🌑,🌑,🌑,🌑,🌑,🌑
|🌑,🌑,🌑,🌑,🌑,🌑,🌑,🌑,🌑,🌑,🌑,🌑,🌑,🌑,🌑,🌑,🌑,🌑,🌑,🌑,🌑,🌑,🌑,🌑,🌑,🌑,🌑,🌑,🌑,🌑,🌑,🌑,🌑,🌑,🌑,🌑,🌑,🌑,🌑,🌑
|🌑,🌑,🌑,🌑,🌑,🌑,🌑,🌑,🌑,🌑,🌑,🌑,🌑,🌑,🌑,🌑,🌑,🌑,🌑,🌑,🌑,🌑,🌑,🌑,🌑,🌑,🌑,🌑,🌑,🌑,🌑,🌑,🌑,🌑,🌑,🌑,🌑,🌑,🌑,🌑
|🌑,🌑,🌑,🌑,🌑,🌑,🌑,🌑,🌑,🌑,🌑,🌑,🌑,🌑,🌑,🌑,🌑,🌑,🌑,🌑,🌑,🌑,🌑,🌑,🌑,🌑,🌑,🌑,🌑,🌑,🌑,🌑,🌑,🌑,🌑,🌑,🌑,🌑,🌑,🌑
|🌑,🌑,🌑,🌑,🌑,🌑,🌑,🌑,🌑,🌑,🌑,🌑,🌑,🌑,🌑,🌑,🌑,🌑,🌑,🌑,🌑,🌑,🌑,🌑,🌑,🌑,🌑,🌑,🌑,🌑,🌑,🌑,🌑,🌑,🌑,🌑,🌑,🌑,🌑,🌑
|🌑,🌑,🌑,🌑,🌑,🌑,🌑,🌑,🌑,🌑,🌑,🌑,🌑,🌑,🌑,🌑,🌑,🌑,🌑,🌑,🌑,🌑,🌑,🌑,🌑,🌑,🌑,🌑,🌑,🌑,🌑,🌑,🌑,🌑,🌑,🌑,🌑,🌑,🌑,🌑
|🌑,🌑,🌑,🌑,🌑,🌑,🌑,🌑,🌑,🌑,🌑,🌑,🌑,🌑,🌑,🌑,🌑,🌑,🌑,🌑,🌑,🌑,🌑,🌑,🌑,🌑,🌑,🌑,🌑,🌑,🌑,🌑,🌑,🌑,🌑,🌑,🌑,🌑,🌑,🌑
|✳️,🌑,🌑,🌑,🌑,🌑,🌑,🌑,🌑,🌑,🌑,🌑,🌑,🌑,🌑,🌑,🌑,🌑,🌑,✳️,🌑,🌑,🌑,🌑,🌑,🌑,🌑,🌑,🌑,🌑,🌑,🌑,🌑,🌑,🌑,🌑,🌑,🌑,✳️,🌑
|🌑,🌑,🌑,🌑,🌑,🌑,🌑,🌑,🌑,🌑,🌑,🌑,🌑,🌑,🌑,🌑,🌑,🌑,🌑,🌑,🌑,🌑,🌑,🌑,🌑,🌑,🌑,🌑,🌑,🌑,🌑,🌑,🌑,🌑,🌑,🌑,🌑,🌑,🌑,🌑
|🌑,🌑,🌑,🌑,🌑,🌑,🌑,🌑,🌑,🌑,🌑,🌑,🌑,🌑,🌑,🌑,🌑,🌑,🌑,🌑,🌑,🌑,🌑,🌑,🌑,🌑,🌑,🌑,🌑,🌑,🌑,🌑,🌑,🌑,🌑,🌑,🌑,🌑,🌑,🌑
|🌑,🌑,🌑,🌑,🌑,🌑,🌑,🌑,🌑,🌑,🌑,🌑,🌑,🌑,🌑,🌑,🌑,🌑,🌑,🌑,🌑,🌑,🌑,🌑,🌑,🌑,🌑,🌑,🌑,🌑,🌑,🌑,🌑,🌑,🌑,🌑,🌑,🌑,🌑,🌑
|🌑,🌑,🌑,🌑,🌑,🌑,🌑,🌑,🌑,🌑,🌑,🌑,🌑,🌑,🌑,🌑,🌑,🌑,🌑,🌑,🌑,🌑,🌑,🌑,🌑,🌑,🌑,🌑,🌑,🌑,🌑,🌑,🌑,🌑,🌑,🌑,🌑,🌑,🌑,🌑
|🌑,🌑,🌑,🌑,🌑,🌑,🌑,🌑,🌑,🌑,🌑,🌑,🌑,🌑,🌑,🌑,🌑,🌑,🌑,🌑,🌑,🌑,🌑,🌑,🌑,🌑,🌑,🌑,🌑,🌑,🌑,🌑,🌑,🌑,🌑,🌑,🌑,🌑,🌑,🌑
|🌑,🌑,🌑,🌑,🌑,🌑,🌑,🌑,🌑,🌑,🌑,🌑,🌑,🌑,🌑,🌑,🌑,🌑,🌑,🌑,🌑,🌑,🌑,🌑,🌑,🌑,🌑,🌑,🌑,🌑,🌑,🌑,🌑,🌑,🌑,🌑,🌑,🌑,🌑,🌑
|🌑,🌑,🌑,🌑,🌑,🌑,🌑,🌑,🌑,🌑,🌑,🌑,🌑,🌑,🌑,🌑,🌑,🌑,🌑,🌑,🌑,🌑,🌑,🌑,🌑,🌑,🌑,🌑,🌑,🌑,🌑,🌑,🌑,🌑,🌑,🌑,🌑,🌑,🌑,🌑
|🌑,🌑,🌑,🌑,🌑,🌑,🌑,🌑,🌑,🌑,🌑,🌑,🌑,🌑,🌑,🌑,🌑,🌑,🌑,🌑,🌑,🌑,🌑,🌑,🌑,🌑,🌑,🌑,🌑,🌑,🌑,🌑,🌑,🌑,🌑,🌑,🌑,🌑,🌑,🌑
|🌑,🌑,🌑,🌑,🌑,🌑,🌑,🌑,🌑,🌑,🌑,🌑,🌑,🌑,🌑,🌑,🌑,🌑,🌑,🌑,🌑,🌑,🌑,🌑,🌑,🌑,🌑,🌑,🌑,🌑,🌑,🌑,🌑,🌑,🌑,🌑,🌑,🌑,🌑,🌑
|🌑,🌑,🌑,🌑,🌑,🌑,🌑,🌑,🌑,🌑,🌑,🌑,🌑,🌑,🌑,🌑,🌑,🌑,🌑,🌑,🌑,🌑,🌑,🌑,🌑,🌑,🌑,🌑,🌑,🌑,🌑,🌑,🌑,🌑,🌑,🌑,🌑,🌑,🌑,🌑
|🌑,🌑,🌑,🌑,🌑,🌑,🌑,🌑,🌑,🌑,🌑,🌑,🌑,🌑,🌑,🌑,🌑,🌑,🌑,🌑,🌑,🌑,🌑,🌑,🌑,🌑,🌑,🌑,🌑,🌑,🌑,🌑,🌑,🌑,🌑,🌑,🌑,🌑,🌑,🌑
|🌑,🌑,🌑,🌑,🌑,🌑,🌑,🌑,🌑,🌑,🌑,🌑,🌑,🌑,🌑,🌑,🌑,🌑,🌑,🌑,🌑,🌑,🌑,🌑,🌑,🌑,🌑,🌑,🌑,🌑,🌑,🌑,🌑,🌑,🌑,🌑,🌑,🌑,🌑,🌑
|🌑,🌑,🌑,🌑,🌑,🌑,🌑,🌑,🌑,🌑,🌑,🌑,🌑,🌑,🌑,🌑,🌑,🌑,🌑,🌑,🌑,🌑,🌑,🌑,🌑,🌑,🌑,🌑,🌑,🌑,🌑,🌑,🌑,🌑,🌑,🌑,🌑,🌑,🌑,🌑
|🌑,🌑,🌑,🌑,🌑,🌑,🌑,🌑,🌑,🌑,🌑,🌑,🌑,🌑,🌑,🌑,🌑,🌑,🌑,🌑,🌑,🌑,🌑,🌑,🌑,🌑,🔲,🌑,🌑,🌑,🌑,🌑,🌑,🌑,🌑,🌑,🌑,🌑,🌑,🌑
|🌑,🌑,🌑,🌑,🌑,🌑,🌑,🌑,🌑,🌑,🌑,🌑,🌑,🌑,🌑,🌑,🌑,🌑,🌑,🌑,🌑,🌑,🌑,🌑,🌑,🌑,🌑,🌑,🌑,🌑,🌑,🌑,🌑,🌑,🌑,🌑,🌑,🌑,🌑,🌑
|🌑,🌑,🌑,🌑,🌑,🌑,🌑,🌑,🌑,🌑,🌑,🌑,🌑,🌑,🌑,🌑,🌑,🌑,🌑,🌑,🌑,🌑,🌑,🌑,🌑,🌑,🌑,🌑,🌑,🌑,🌑,🌑,🌑,🌑,🌑,🌑,🌑,🌑,🌑,🌑
|🌑,🌑,🌑,🌑,🌑,🌑,🌑,🌑,🌑,🌑,🌑,🌑,🌑,🌑,🌑,🌑,🌑,🌑,🌑,🌑,🌑,🌑,🌑,🌑,🌑,🌑,🌑,🌑,🌑,🌑,🌑,🌑,🌑,🌑,🌑,🌑,🌑,🌑,🌑,🌑
|🌑,🌑,🌑,🌑,🌑,🌑,🌑,🌑,🌑,🌑,🌑,🌑,🌑,🌑,🌑,🌑,🌑,🌑,🌑,🌑,🌑,🌑,🌑,🌑,🌑,🌑,🌑,🌑,🌑,🌑,🌑,🌑,🌑,🌑,🌑,🌑,🌑,🌑,🌑,🌑
|🌑,🌑,🌑,🌑,🌑,🌑,🌑,🌑,🌑,🌑,🌑,🌑,🌑,🌑,🌑,⭕️,🌑,🌑,🌑,🌑,🌑,🌑,🌑,🌑,🌑,🌑,🌑,🌑,🌑,🌑,🌑,🌑,🌑,🌑,🌑,🌑,🌑,🌑,🌑,🌑
|🌑,🌑,🌑,🌑,🌑,🌑,🌑,🌑,⭕️,⭕️,⭕️,🌑,🌑,🌑,⭕️,🌑,🌑,🌑,🌑,🌑,🌑,🌑,🌑,🌑,🌑,🌑,🌑,🌑,🌑,🌑,🌑,🌑,🌑,🌑,🌑,🌑,🌑,🌑,🌑,🌑
|🌑,🌑,🌑,🌑,🌑,🌑,🌑,🌑,🌑,☢️,🌑,🌑,🌑,⭕️,🌑,⭕️,🌑,🌑,🌑,🌑,🌑,🌑,🌑,🌑,🌑,🌑,🌑,🌑,🌑,🌑,🌑,🌑,🌑,🌑,🌑,🌑,🌑,🌑,🌑,🌑
|🌑,🌑,🌑,🌑,🌑,🌑,🌑,🌑,🌑,🌑,🌑,🌑,🌑,🌑,🌑,🌑,🌑,🌑,🌑,🌑,🌑,🌑,🌑,🌑,🌑,🌑,🌑,🌑,🌑,🌑,🌑,🌑,🌑,🌑,🌑,🌑,🌑,🌑,🌑,🌑
|🌑,🌑,🌑,🌑,🌑,🌑,🌑,⭕️,🔲,🌑,🌑,🌑,🌑,🌑,🌑,🌑,🌑,🌑,🌑,🌑,🌑,🌑,🌑,🌑,🌑,🌑,🌑,🌑,🌑,🌑,🌑,🌑,🌑,🌑,🌑,🌑,🌑,🌑,🌑,🌑
|🌑,🌑,🌑,🌑,🌑,🌑,⭕️,🌑,🌑,🌑,⭕️,⭕️,⭕️,🌑,🌑,🌑,🌑,🌑,🌑,🌑,🌑,🌑,🌑,🌑,🌑,🌑,🌑,🌑,🌑,🌑,🌑,🌑,🌑,🌑,🌑,🌑,🌑,🌑,🌑,🌑
|🌑,🌑,🌑,🌑,🌑,⭕️,🌑,☢️,🌑,🌑,🌑,☢️,🌑,🌑,🌑,🌑,🌑,🌑,🌑,🌑,🌑,🌑,🌑,🌑,🌑,🌑,🌑,🌑,🌑,🌑,🌑,🌑,🌑,🌑,🌑,🌑,🌑,🌑,🌑,🌑
|🌑,🌑,🌑,🌑,🌑,🌑,🌑,🌑,🌑,🌑,🌑,🌑,🌑,🌑,🌑,🌑,🌑,🌑,🌑,🌑,🌑,🌑,🌑,🌑,🌑,🌑,🌑,🌑,🌑,🌑,🌑,🌑,🌑,🌑,🌑,🌑,🌑,🌑,🌑,🌑
|🌑,🌑,🌑,🌑,🌑,🌑,🌑,🌑,🌑,🌑,🌑,🌑,🌑,🌑,🌑,🌑,🌑,🌑,🌑,🌑,🌑,🌑,🌑,🌑,🌑,🌑,🌑,🌑,🌑,🌑,🌑,🌑,🌑,🌑,🌑,🌑,🌑,🌑,🌑,🌑
|🌑,🌑,🌑,🌑,🌑,🌑,🌑,🌑,🌑,⭕️,⭕️,🌑,🌑,🌑,🌑,🌑,🌑,🌑,🌑,🌑,🌑,🌑,🌑,🌑,🌑,🌑,🌑,🌑,🌑,🌑,🌑,🌑,🌑,🌑,🌑,🌑,🌑,🌑,🌑,🌑
|🌑,🌑,🌑,🌑,🌑,🌑,🌑,🌑,🌑,🌑,🌑,🌑,🌑,🌑,🌑,🌑,🌑,🌑,🌑,🌑,🌑,🌑,🌑,🌑,🌑,🌑,🌑,🌑,🌑,🌑,🌑,🌑,🌑,🌑,🌑,🌑,🌑,🌑,🌑,🌑
|🌑,🌑,🌑,🌑,🌑,🌑,🌑,🌑,🌑,🌑,🌑,🌑,🌑,🌑,🌑,🌑,🌑,🌑,🌑,🌑,🌑,🌑,🌑,🌑,🌑,🌑,🌑,🌑,🌑,🌑,🌑,🌑,🌑,🌑,🌑,🌑,🌑,🌑,🌑,🌑
|🌑,🌑,🌑,🌑,🌑,🌑,🌑,🌑,🌑,🌑,🌑,🌑,🌑,🌑,🌑,🌑,🌑,🌑,🌑,🌑,🌑,🌑,🌑,🌑,🌑,🌑,🌑,↗️,🌑,🌑,🌑,🌑,🌑,🌑,🌑,🌑,🌑,⬆️,🌑,🌑
|🌑,🌑,🌑,🌑,🌑,🌑,🌑,🌑,🌑,🌑,🌑,🌑,🌑,🌑,🌑,🌑,🌑,⭕️,⭕️,⭕️,🌑,🌑,🌑,🌑,🌑,🌑,🌑,🌑,🌑,🌑,🌑,🌑,🌑,🌑,🌑,🌑,🌑,🌑,🌑,🌑
|🌑,🌑,🌑,🌑,🌑,🌑,🌑,🌑,🌑,🌑,🌑,🌑,🌑,🌑,🌑,🌑,🌑,⭕️,⭕️,⭕️,🌑,🌑,🌑,🌑,🌑,🌑,🌑,🌑,🌑,🌑,🌑,🌑,🌑,🌑,🌑,🌑,🌑,🌑,🌑,🌑
|🌑,🌑,🌑,🌑,🌑,🌑,🌑,🌑,🌑,🌑,🌑,🌑,🌑,🌑,🌑,🌑,🌑,⭕️,☢️,⭕️,🌑,🌑,🌑,🌑,🌑,🌑,🌑,🌑,🌑,🌑,🌑,🌑,🌑,🌑,🌑,🌑,🌑,🌑,🌑,🌑
|🌑,🌑,🌑,🌑,🌑,🌑,🌑,🌑,🌑,🌑,🌑,🌑,🌑,🌑,🌑,🌑,🌑,🌑,🌑,🌑,🌑,🌑,🌑,🌑,🌑,🌑,🌑,🌑,🌑,🌑,🌑,🌑,🌑,🌑,🌑,🌑,🌑,🌑,🌑,🌑
|🌑,🌑,🌑,🌑,🌑,🌑,🌑,🌑,🌑,🌑,🌑,🌑,🌑,🌑,🌑,🌑,🌑,🌑,🌑,🌑,🌑,🌑,🌑,🌑,🌑,🌑,🌑,🌑,🌑,🌑,🌑,🌑,🌑,🌑,🌑,🌑,🌑,🌑,🌑,🌑
|🌑,🌑,🌑,🌑,🌑,🌑,🌑,🌑,🌑,🕧,🌑,🌑,🌑,🌑,🌑,➡️,🌑,🌑,🌑,🌑,🌑,⬅️,🌑,🌑,🌑,🌑,🕧,🌑,🌑,🌑,🌑,🌑,🌑,🌑,🌑,🌑,🌑,🌑,🌑,🌑
|🌑,🌑,🌑,🌑,🌑,🌑,🌑,🌑,🌑,🌑,🌑,🌑,🌑,🌑,🌑,🌑,🌑,🌑,🌑,🌑,🌑,🌑,🌑,🌑,🌑,🌑,🌑,🌑,🌑,🌑,🌑,🌑,🌑,🌑,🌑,🌑,🌑,🌑,🌑,🌑
|🌑,🌑,⬆️,🌑,🌑,🌑,⬆️,🌑,🌑,🌑,🌑,🌑,🌑,🌑,🌑,🌑,🌑,🌑,🌑,🌑,🌑,🌑,🌑,🌑,🌑,🌑,🌑,🌑,🌑,🌑,🌑,🌑,🌑,🌑,🌑,🌑,🌑,🌑,🌑,🌑
|🌑,🌑,🌑,🌑,🌑,🌑,🌑,🌑,🌑,🌑,🌑,🌑,🌑,🌑,🌑,🌑,🌑,🌑,🌑,🌑,🌑,🌑,🌑,🌑,🌑,🌑,🌑,🌑,🌑,🌑,🌑,🌑,🌑,🌑,🌑,🌑,🌑,🌑,🌑,🌑
|🌑,🌑,🌑,🌑,🌑,🌑,🌑,🌑,🌑,🌑,🌑,🌑,🌑,🌑,🌑,🌑,🌑,🌑,🌑,🌑,🌑,🌑,🌑,🌑,🌑,🌑,🌑,🌑,🌑,🌑,🌑,🌑,🌑,🌑,🌑,🌑,🌑,🌑,🌑,🌑
|🌑,🌑,🌑,🌑,🌑,🌑,🌑,🌑,🌑,🌑,🌑,🌑,🌑,🌑,🌑,🌑,🌑,🌑,🌑,🌑,🌑,🌑,🌑,🌑,🌑,🌑,🌑,🌑,🌑,🌑,🌑,🌑,🌑,🌑,🌑,🌑,🌑,🌑,🌑,🌑
|🌑,🌑,🌑,🌑,🌑,🌑,🌑,🌑,🌑,🌑,🌑,🌑,🌑,🌑,🌑,🌑,🌑,🌑,🌑,🌑,🌑,🌑,🌑,🌑,🌑,🌑,🌑,🌑,🌑,🌑,🌑,🌑,🌑,🌑,🌑,🌑,🌑,🌑,🌑,🌑
|🌑,🌑,🌑,🌑,🌑,🌑,🌑,🌑,🌑,🌑,🌑,🌑,🌑,🌑,🌑,🌑,🌑,⭕️,🌑,🌑,🌑,🌑,🌑,🌑,🌑,🌑,🌑,🌑,🌑,🌑,🌑,🌑,🌑,🌑,🌑,🌑,🌑,🌑,🌑,🌑
|🌑,🌑,🌑,🌑,🌑,🌑,🌑,🌑,🌑,🌑,🌑,🌑,🌑,🌑,🌑,🌑,🌑,🌑,⭕️,⭕️,🌑,🌑,🌑,🌑,🌑,🌑,🌑,🌑,🌑,🌑,🌑,🌑,🌑,🌑,🚰,🌑,🌑,🌑,🌑,🌑
|🚰,🌑,🌑,🌑,🌑,🌑,🌑,🌑,🌑,🌑,🌑,🌑,🌑,🌑,➡️,🌑,🌑,🌑,🌑,🌑,⬅️,🌑,🌑,🌑,🌑,🌑,🌑,🌑,🌑,🌑,🌑,🌑,🌑,🌑,🌑,🌑,🌑,🌑,🌑,🌑
|🌑,🌑,🌑,🌑,🌑,🌑,🌑,🌑,🌑,🌑,🌑,🌑,🌑,🌑,🌑,🌑,🌑,🌑,🌑,🌑,🌑,🌑,🌑,🌑,🌑,🌑,🌑,🌑,🌑,🌑,🌑,🌑,🌑,🌑,🌑,🌑,🌑,🌑,🌑,🌑
|🌑,🌑,🌑,🌑,🌑,🌑,🌑,🌑,🌑,🌑,🌑,🌑,🌑,🌑,🌑,🌑,🌑,⭕️,🌑,🌑,🌑,🌑,🌑,🌑,🌑,🌑,🌑,🌑,🌑,🌑,🌑,🌑,🌑,🌑,🌑,🌑,🌑,🌑,🌑,🌑
|🌑,🌑,🌑,🌑,🌑,🌑,🌑,🌑,🌑,🌑,🌑,🌑,🌑,🌑,🌑,⭕️,⭕️,🌑,🌑,🌑,🌑,🌑,🌑,🌑,🌑,🌑,🌑,🌑,🌑,🌑,🌑,🌑,🌑,🌑,🌑,🌑,🌑,🌑,🌑,🌑
|🌑,🌑,🌑,🌑,🌑,🌑,🌑,🌑,🌑,🌑,🌑,🌑,🌑,🌑,🌑,🌑,🌑,🌑,🌑,🌑,🌑,🌑,🌑,🌑,🌑,🌑,🌑,🌑,🌑,🌑,🌑,🌑,🌑,🌑,🌑,🌑,🌑,🌑,🌑,🌑
|🌑,🌑,🌑,🌑,🌑,🌑,🌑,🌑,🌑,🌑,🌑,🌑,🌑,🌑,🌑,🌑,🌑,🌑,🌑,🌑,⭕️,🌑,🌑,🌑,🌑,🌑,🌑,🌑,🌑,🌑,🌑,🌑,🌑,🌑,🌑,🌑,🌑,🌑,🌑,🌑
|🌑,🌑,🌑,🌑,🌑,🌑,🌑,🌑,🌑,🌑,🌑,🌑,🌑,🌑,🌑,🌑,🌑,🌑,⭕️,⭕️,🌑,🌑,🌑,🌑,🌑,🌑,🌑,🌑,🌑,🌑,🌑,🌑,🌑,🌑,🌑,🌑,🌑,🌑,🌑,🌑
|🌑,🌑,🌑,🌑,🌑,🌑,🌑,🌑,🌑,🌑,🌑,🌑,🌑,🌑,🌑,🌑,🌑,🌑,🌑,🌑,🌑,🌑,🌑,🌑,🌑,🌑,🌑,🌑,🌑,🌑,🌑,🌑,🌑,🌑,🌑,🌑,🌑,🌑,🌑,🌑
|🌑,🌑,🌑,🌑,🌑,🌑,🌑,🌑,🌑,🌑,🌑,🌑,🌑,🌑,🌑,🌑,🌑,🌑,🌑,🌑,🌑,🌑,🌑,🌑,🌑,🌑,🌑,🌑,🌑,🌑,🌑,🌑,🌑,🌑,🌑,🌑,🌑,🌑,🌑,🌑
|🌑,🌑,🌑,🌑,🌑,🌑,🌑,🌑,🌑,🕧,🌑,🌑,🌑,🌑,🌑,➡️,🌑,🌑,🌑,🌑,🌑,⬅️,🌑,🌑,🌑,🌑,🕧,🌑,🌑,🌑,🌑,🌑,🌑,🌑,🌑,🌑,🌑,🌑,🌑,🌑
|🌑,🌑,🌑,🌑,🌑,🌑,🌑,🌑,🌑,🌑,🌑,🌑,🌑,🌑,🌑,🌑,🌑,🌑,🌑,🌑,🌑,🌑,🌑,🌑,🌑,🌑,🌑,🌑,🌑,🌑,🌑,🌑,🌑,🌑,🌑,🌑,🌑,🌑,🌑,🌑
|🌑,🌑,🌑,🌑,🌑,🌑,🌑,🌑,🌑,🌑,🌑,🌑,🌑,🌑,🌑,🌑,⭕️,🌑,🌑,🌑,🌑,⭕️,🌑,🌑,🌑,🌑,🌑,🌑,🌑,🌑,🌑,🌑,🌑,🌑,🌑,🌑,🌑,🌑,🌑,🌑
|🌑,🌑,🌑,🌑,🌑,🌑,🌑,🌑,🌑,🌑,🌑,🌑,🌑,🌑,🌑,⭕️,⭕️,⭕️,🌑,🌑,⭕️,⭕️,⭕️,🌑,🌑,🌑,🌑,🌑,🌑,🌑,🌑,🌑,🌑,🌑,🌑,🌑,🌑,🌑,🌑,🌑
|🌑,🌑,🌑,🌑,🌑,🌑,🌑,🌑,🌑,🌑,🌑,🌑,🌑,🌑,🌑,🌑,☢️,🌑,🌑,🌑,🌑,☢️,🌑,🌑,🌑,🌑,🌑,🌑,🌑,🌑,🌑,🌑,🌑,🌑,🌑,🌑,🌑,🌑,🌑,🌑
|🌑,🌑,🌑,🌑,🌑,🌑,🌑,🌑,🌑,🌑,🌑,🌑,🌑,🌑,🌑,🌑,🌑,🌑,🌑,🌑,🌑,🌑,🌑,🌑,🌑,🌑,🌑,🌑,🌑,🌑,🌑,🌑,🌑,🌑,🌑,🌑,🌑,🌑,🌑,🌑
|⬇️,🌑,🌑,🌑,🌑,🌑,🌑,🌑,🌑,↘️,🌑,🌑,🌑,🌑,🌑,🌑,🌑,🌑,🌑,🌑,🌑,🌑,🌑,🌑,🌑,🌑,↙️,🌑,🌑,🌑,🌑,🌑,🌑,🌑,🌑,🌑,🌑,🌑,🌑,🌑
|🌑,🌑,🌑,🌑,🌑,🌑,🌑,🌑,🌑,🌑,🌑,🌑,🌑,🌑,🌑,🌑,🌑,🌑,🌑,🌑,🌑,🌑,🌑,🌑,🌑,🌑,🌑,🌑,🌑,🌑,🌑,🌑,🌑,🌑,🌑,🌑,🌑,🌑,🌑,🌑
|🌑,🌑,🌑,🌑,🌑,🌑,🌑,🌑,🌑,🌑,🌑,🌑,🌑,🌑,🌑,🌑,🌑,🌑,🌑,🌑,🌑,🌑,🌑,🌑,🌑,🌑,🌑,🌑,🌑,🌑,🌑,🌑,🌑,🌑,⬇️,🌑,🌑,🌑,🌑,⬇️
|🌑,🌑,🌑,🌑,🌑,🌑,🌑,🌑,🌑,🌑,🌑,🌑,🌑,🌑,🌑,🌑,🌑,🌑,🌑,🌑,🌑,🌑,🌑,🌑,🌑,🌑,🌑,🌑,🌑,🌑,🌑,🌑,🌑,🌑,🌑,🌑,🌑,🌑,🌑,🌑
|🌑,🌑,🌑,🌑,🌑,🌑,🌑,🌑,🌑,🌑,🌑,🌑,🌑,🌑,🌑,🌑,🌑,🌑,🌑,🌑,🌑,🌑,🌑,🌑,🌑,🌑,🌑,🌑,🌑,🌑,🌑,🌑,🌑,🌑,🌑,🌑,🌑,🌑,🌑,🌑
|🌑,🌑,🌑,🌑,🌑,🌑,🌑,🌑,🌑,🌑,🌑,🌑,🌑,🌑,🌑,🌑,🌑,🌑,🌑,🌑,🌑,🌑,🌑,🌑,🌑,🌑,🌑,🌑,🌑,🌑,🌑,🌑,🌑,🌑,🌑,🌑,🌑,🌑,🌑,🌑
|🌑,🌑,🌑,🌑,🌑,🌑,🌑,🌑,🌑,🌑,🌑,🌑,🌑,🌑,🌑,🌑,🌑,🌑,🌑,🌑,🌑,🌑,🌑,🌑,🌑,🌑,⭕️,🌑,⭕️,🌑,🌑,🌑,🌑,🌑,🌑,🌑,🌑,🌑,🌑,🌑
|🌑,🌑,🌑,🌑,🌑,🌑,🌑,🌑,🌑,🌑,🌑,🌑,🌑,🌑,🌑,🌑,🌑,🌑,🌑,🌑,🌑,🌑,🌑,🌑,🌑,⭕️,⭕️,🌑,⭕️,⭕️,🌑,🌑,🌑,🌑,🌑,🌑,🌑,🌑,🌑,🌑
|🌑,🌑,🌑,🌑,🌑,🌑,🌑,🌑,🌑,🌑,🌑,🌑,🌑,🌑,🌑,🌑,🌑,🌑,🌑,🌑,🌑,🌑,🌑,🌑,🌑,☢️,⭕️,🌑,⭕️,☢️,🌑,🌑,🌑,🌑,🌑,🌑,🌑,🌑,🌑,🌑
|🌑,🌑,🌑,🌑,🌑,🌑,🌑,🌑,🌑,🌑,🌑,🌑,🌑,🌑,🌑,🌑,🌑,🌑,🌑,🌑,🌑,🌑,🌑,🌑,🌑,🌑,🌑,⭕️,🌑,🌑,🌑,🌑,🌑,🌑,🌑,🌑,🌑,🌑,🌑,🌑
|🌑,🌑,🌑,🌑,🌑,🌑,🌑,🌑,🌑,🌑,🌑,🌑,🌑,🌑,🌑,🌑,🌑,🌑,🌑,🌑,🌑,🌑,🌑,🌑,🌑,🌑,⭕️,🌑,⭕️,🌑,🌑,🌑,🌑,🌑,🌑,🌑,🌑,🌑,🌑,🌑
|🌑,🌑,🌑,🌑,🌑,⭕️,🌑,🌑,🌑,🌑,🌑,🌑,🌑,🌑,🌑,🌑,🌑,🌑,🌑,🌑,🌑,🌑,🌑,🌑,🌑,🌑,🌑,☢️,🌑,🌑,🌑,🌑,🌑,🌑,🌑,🌑,🌑,🌑,🌑,🌑
|🌑,🌑,🌑,🌑,⭕️,🌑,🌑,🌑,🌑,🌑,🌑,🌑,🌑,🌑,🌑,🌑,🌑,🌑,🌑,🌑,🌑,🌑,🌑,🌑,🌑,🌑,🌑,🌑,🌑,🌑,🌑,🌑,🌑,🌑,🌑,🌑,🌑,🌑,🌑,🌑
|🌑,🌑,🌑,⭕️,🌑,☢️,🌑,🌑,🌑,🌑,🌑,🌑,🌑,🌑,🌑,🌑,🌑,🌑,🌑,🌑,🌑,🌑,🌑,🌑,🌑,🌑,🌑,🌑,🌑,🌑,🌑,🌑,🌑,🌑,🌑,🌑,🌑,🌑,🌑,🌑
|🌑,🌑,🌑,🌑,🌑,🌑,🌑,🌑,🌑,⭕️,⭕️,⭕️,🌑,🌑,🌑,🌑,🌑,🌑,🌑,🌑,🌑,🌑,🌑,🌑,🌑,🌑,🌑,🌑,🌑,🌑,🌑,🌑,🌑,🌑,🌑,🌑,🌑,🌑,🌑,🌑
|🌑,🌑,🌑,🌑,🌑,🌑,🌑,🌑,🌑,🌑,☢️,🌑,🌑,🌑,🌑,🌑,🌑,🌑,🌑,🌑,🌑,🌑,🌑,🌑,🌑,🌑,🌑,🌑,🌑,🌑,🌑,🌑,🌑,🌑,🌑,🌑,🌑,🌑,⚪️,🌑
|🌑,🌑,🌑,🌑,🌑,🌑,🌑,🌑,🌑,🌑,🌑,🌑,🌑,🌑,🌑,🌑,🌑,🌑,🌑,⚪️,🌑,🌑,🌑,🌑,🌑,🌑,🌑,🌑,🌑,🌑,🌑,🌑,🌑,🌑,🌑,🌑,🌑,🌑,🌑,🌑
|🌑,🔲,🌑,🌑,🌑,🌑,🌑,🌑,🌑,🌑,🌑,🌑,🌑,🌑,🌑,🔲,🌑,🌑,🌑,🌑,🌑,🌑,🌑,🌑,🔲,🌑,🌑,🌑,🌑,🌑,🌑,🔲,🌑,🌑,🌑,🌑,🌑,🌑,🌑,🌑
|🌑,🌑,🌑,🌑,🌑,🌑,🌑,🌑,🌑,🌑,🌑,🌑,🌑,🌑,🌑,🌑,🌑,⚪️,🌑,⚪️,🌑,🌑,🌑,🌑,🌑,🌑,🌑,🌑,🌑,🌑,🌑,🌑,🌑,🌑,🌑,🌑,🌑,🌑,🌑,🌑
|🌑,🌑,🌑,🌑,🌑,🌑,🌑,🌑,🌑,🌑,🌑,🌑,🌑,🌑,🌑,🌑,🌑,🌑,🌑,🌑,🌑,⚪️,🌑,🌑,🌑,🌑,🌑,🌑,🌑,🌑,🌑,🌑,🌑,🌑,🌑,🌑,🌑,🌑,🌑,🌑
|🌑,🌑,🌑,🌑,⚪️,🌑,🌑,🌑,🌑,🌑,🌑,🌑,🌑,🌑,🌑,🌑,🌑,🌑,🌑,🌑,🌑,🌑,🌑,🌑,🌑,🌑,🌑,🌑,🌑,🌑,🌑,🌑,🌑,🌑,🌑,🌑,🌑,🌑,🌑,🌑
|🌑,🌑,🌑,🌑,🌑,🌑,🌑,🌑,🌑,🌑,🌑,🌑,🌑,🌑,🌑,🌑,🌑,🌑,🌑,🌑,🌑,🌑,🌑,🌑,🌑,🌑,🌑,🌑,🌑,🌑,🌑,🌑,🌑,🌑,🌑,🌑,🌑,🌑,🌑,🌑
|🌑,🌑,🌑,🌑,🌑,🌑,🌑,🌑,🌑,🌑,🌑,🌑,🌑,🌑,🌑,🌑,🌑,🌑,🌑,🌑,🌑,🌑,🌑,🌑,🌑,🌑,🌑,🌑,🌑,🌑,🌑,🌑,🌑,🌑,🌑,🌑,🌑,🌑,🌑,🌑
|🌑,🌑,🌑,🌑,🌑,🌑,🌑,🌑,🌑,🌑,🌑,🌑,🌑,🌑,🌑,🌑,🌑,🌑,🌑,🌑,🌑,🌑,🌑,🌑,🌑,🌑,🌑,🌑,🌑,🌑,🌑,🌑,🌑,🌑,🌑,🌑,🌑,🌑,🌑,🌑
|🌑,🌑,🌑,🌑,🌑,🌑,🌑,🌑,🌑,🌑,🌑,🌑,🌑,🌑,🌑,🌑,🌑,🌑,🌑,🌑,🌑,🌑,🌑,🌑,🌑,🌑,🌑,🌑,🌑,🌑,🌑,🌑,🌑,🌑,🌑,🌑,🌑,🌑,🌑,🌑
|🌑,🌑,🌑,🌑,🌑,🌑,🌑,🌑,🌑,🌑,🌑,🌑,🌑,🌑,🌑,🌑,🌑,🌑,🌑,🌑,🌑,🌑,🌑,🌑,🌑,🌑,🌑,🌑,🌑,🌑,🌑,🌑,🌑,🌑,🌑,🌑,🌑,🌑,🌑,🌑
|🌑,🌑,🌑,🌑,🌑,🌑,🌑,🌑,🌑,🌑,🌑,🌑,🌑,🌑,🌑,🔲,🌑,🌑,🌑,🌑,🌑,🌑,🌑,🌑,🔲,🌑,🌑,🌑,🌑,🌑,🌑,🔲,🌑,🌑,🌑,🌑,🌑,🌑,🌑,🌑
|🌑,🔲,🌑,🌑,⚪️,🌑,🌑,🌑,🌑,🌑,🌑,🌑,🌑,🌑,🌑,🌑,🌑,🌑,🌑,🌑,🌑,🌑,🌑,🌑,🌑,🌑,🌑,🌑,🌑,🌑,🌑,🌑,🌑,🌑,🌑,🌑,🌑,🌑,🌑,🌑
|🌑,🌑,🌑,🌑,🌑,🌑,🌑,🌑,🌑,🌑,🌑,🌑,🌑,🌑,🌑,🌑,🌑,🌑,🌑,🌑,🌑,🌑,🌑,🌑,🌑,🌑,🌑,🌑,🌑,🌑,🌑,🌑,🌑,🌑,🌑,🌑,🌑,🌑,🌑,🌑
|🌑,🌑,🌑,🌑,🌑,🌑,🌑,🌑,🌑,🌑,🌑,🌑,🌑,🌑,🌑,🌑,🌑,🌑,🌑,🌑,🌑,🌑,🌑,🌑,🌑,🌑,🌑,🌑,🌑,🌑,🌑,🌑,🌑,🌑,🌑,🌑,🌑,🌑,🌑,🌑
|🌑,🌑,🌑,🌑,🌑,🌑,🌑,🌑,🌑,🌑,🌑,🌑,🌑,🌑,🌑,🌑,🌑,🌑,🌑,🌑,🌑,🌑,🌑,🌑,🌑,🌑,🌑,🌑,🌑,🌑,🌑,🌑,🌑,🌑,🌑,🌑,🌑,🌑,🌑,🌑
|🌑,🌑,🌑,🌑,🌑,🌑,🌑,🌑,🌑,🌑,🌑,🌑,🌑,🌑,🌑,🌑,🌑,🌑,🌑,🌑,🌑,🌑,🌑,🌑,🌑,🌑,🌑,🌑,🌑,🌑,🌑,🌑,🌑,🌑,🌑,🌑,🌑,🌑,🌑,🌑
|🌑,🌑,🌑,🌑,🌑,🌑,🌑,🌑,🌑,🌑,🌑,🌑,🌑,🌑,🌑,🌑,🌑,⭕️,🌑,🌑,🌑,⭕️,🌑,🌑,🌑,⭕️,🌑,🌑,🌑,🌑,🌑,🌑,🌑,🌑,🌑,🌑,🌑,🌑,🌑,🌑
|🌑,🔲,🌑,🌑,🌑,🌑,🌑,🌑,🌑,🌑,🌑,🌑,🌑,🌑,🌑,🔲,⭕️,🌑,⭕️,🌑,⭕️,🌑,⭕️,🌑,⭕️,🌑,⭕️,🌑,🌑,🌑,🌑,🔲,🌑,🌑,🌑,🌑,🌑,🌑,🌑,🌑
|🌑,🌑,🌑,🌑,🌑,🌑,🌑,🌑,🌑,🌑,🌑,🌑,🌑,🌑,🌑,🌑,🌑,⭕️,🌑,🌑,🌑,⭕️,🌑,🌑,🌑,⭕️,🌑,🌑,🌑,🌑,🌑,🌑,🌑,🌑,🌑,🌑,🌑,🌑,🌑,🌑
|🌑,🌑,🌑,🌑,🌑,🌑,🌑,🌑,🌑,🌑,🌑,🌑,🌑,🌑,🌑,🌑,🌑,🌑,🌑,🌑,🌑,🌑,🌑,🌑,🌑,🌑,🌑,🌑,🌑,🌑,🌑,🌑,🌑,🌑,🌑,🌑,🌑,🌑,🌑,🌑
|🌑,🌑,🌑,🌑,🌑,🌑,🌑,🌑,🌑,🌑,🌑,🌑,🌑,🌑,🌑,🌑,⭕️,🌑,⭕️,🌑,⭕️,🌑,⭕️,🌑,⭕️,🌑,⭕️,🌑,🌑,🌑,🌑,🌑,🌑,🌑,🌑,🌑,🌑,🌑,🌑,🌑
|🌑,⚪️,🌑,🌑,🌑,🌑,🌑,🌑,🌑,🌑,🌑,🌑,🌑,🌑,🌑,🌑,🌑,⭕️,🌑,⭕️,🌑,⭕️,🌑,⭕️,🌑,⭕️,🌑,🌑,🌑,🌑,🌑,🌑,🌑,🌑,🌑,🌑,🌑,🌑,🌑,🌑
|🌑,🌑,🌑,🌑,🌑,🌑,🌑,🌑,🌑,🌑,🌑,🌑,🌑,🌑,🌑,🌑,🌑,🌑,⭕️,☢️,⭕️,☢️,⭕️,☢️,⭕️,🌑,🌑,🌑,🌑,🌑,🌑,🌑,🌑,🌑,🌑,🌑,🌑,🌑,🌑,🌑
|🌑,🌑,🌑,🌑,🌑,🌑,🌑,🌑,🌑,🌑,🌑,🌑,🌑,🌑,🌑,🌑,🌑,🌑,🌑,🌑,🌑,🌑,🌑,🌑,🌑,🌑,🌑,🌑,🌑,🌑,🌑,🌑,🌑,🌑,🌑,🌑,🌑,🌑,🌑,🌑
|🌑,🌑,🌑,🌑,🌑,🌑,🌑,🌑,🌑,🌑,🌑,🌑,🌑,🌑,🌑,🌑,🌑,🌑,🌑,🌑,🌑,🌑,🌑,🌑,🌑,🌑,⚪️,🌑,🌑,🌑,🌑,🌑,🌑,🌑,🌑,🌑,🌑,🌑,🌑,🌑
|🌑,🌑,🌑,🌑,🌑,🌑,🌑,🌑,🌑,🌑,🌑,🌑,🌑,🌑,🌑,🌑,🌑,🌑,🌑,🌑,🌑,🌑,🌑,🌑,🌑,🌑,🌑,🌑,🌑,🌑,🌑,🌑,🌑,🌑,🌑,🌑,🌑,🌑,🌑,🌑
|🌑,🌑,🌑,🌑,🌑,🌑,🌑,🌑,🌑,🌑,🌑,🌑,🌑,🌑,🌑,🔲,🌑,🌑,🌑,🌑,🌑,🌑,🌑,🌑,🔲,🌑,🌑,🌑,🌑,🌑,🌑,🔲,🌑,🌑,🌑,🌑,🌑,🌑,🌑,🌑
|🌑,🔲,🌑,🌑,🌑,🌑,🌑,🌑,🌑,🌑,🌑,🌑,🌑,🌑,🌑,🌑,🌑,🌑,🌑,🌑,🌑,🌑,🌑,🌑,🌑,🌑,🌑,🌑,🌑,🌑,🌑,🌑,🌑,🌑,🌑,🌑,🌑,🌑,🌑,🌑
|🌑,🌑,🌑,🌑,🌑,🌑,🌑,🌑,🌑,🌑,🌑,🌑,🌑,🌑,🌑,🌑,🌑,🌑,🌑,🌑,🌑,🌑,🌑,🌑,🌑,🌑,🌑,🌑,🌑,🌑,🌑,🌑,🌑,🌑,🌑,🌑,⚪️,🌑,🌑,🌑
|⚪️,🌑,🌑,🌑,🌑,🌑,🌑,🌑,🌑,🌑,🌑,🌑,🌑,🌑,🌑,🌑,🌑,🌑,🌑,🌑,🌑,🌑,🌑,🌑,🌑,🌑,🌑,🌑,🌑,🌑,🌑,🌑,🌑,🌑,🌑,🌑,🌑,🌑,🌑,🌑
|🌑,🌑,🌑,🌑,🌑,🌑,🌑,🌑,🌑,🌑,🌑,🌑,🌑,🌑,🌑,😈,🌑,🌑,🌑,🌑,🌑,🌑,🌑,😈,🌑,⭕️,🌑,🌑,😈,🌑,🌑,🌑,🌑,🌑,🌑,🌑,🌑,🌑,🌑,🌑
|🌑,🌑,🌑,🌑,🌑,🌑,🌑,🌑,🌑,⭕️,🌑,⭕️,🌑,⭕️,🌑,🌑,⭕️,🌑,🌑,⭕️,🌑,⭕️,🌑,🌑,⭕️,🌑,⭕️,🌑,🌑,⭕️,🌑,🌑,🌑,🌑,🌑,🌑,🌑,🌑,🌑,🌑
|🌑,🌑,🌑,🌑,🌑,🌑,🌑,🌑,⭕️,🌑,⭕️,🌑,⭕️,🌑,⭕️,🌑,⭕️,🌑,⭕️,🌑,⭕️,🌑,⭕️,⭕️,🌑,⭕️,🌑,⭕️,🌑,⭕️,🌑,🌑,🌑,🌑,🌑,🌑,🌑,🌑,🌑,🌑
|🌑,🌑,🌑,🌑,🌑,🌑,🔲,🌑,🌑,🌑,⭕️,⭕️,⭕️,⭕️,🌑,⭕️,⭕️,⭕️,🌑,⭕️,🌑,⭕️,🌑,⭕️,⭕️,⭕️,⭕️,⭕️,⭕️,🌑,🌑,✳️,🌑,🌑,🌑,🌑,🌑,🌑,🌑,⚪️
|🌑,🌑,🌑,🌑,📛,🌑,⭕️,🌑,📛,🌑,📛,🌑,📛,🌑,🌑,✳️,📛,🌑,📛,🌑,📛,🌑,📛,🌑,📛,🌑,⭕️,🌑,🌑,📛,🌑,📛,🌑,🌑,⭕️,🌑,🌑,🌑,🌑,🌑
|🌑,🌑,⚪️,🌑,🌑,📛,🐚,🌑,🌑,☢️,🌑,☢️,🌑,🌑,🌑,🌑,🌑,☢️,🌑,🌑,🌑,🌑,🌑,☢️,🌑,🌑,☢️,🌑,🌑,🌑,☢️,🌑,🌑,⭕️,🌑,⭕️,🌑,🌑,🌑,🌑
|🌑,🌑,🌑,🌑,🌑,🌑,🌑,🌑,🌑,🌑,🌑,🌑,🌑,🌑,🌑,🌑,🌑,🌑,🌑,🌑,🌑,🌑,🌑,🌑,🌑,🌑,🌑,🌑,🌑,🌑,🌑,🌑,🌑,🌑,📛,🌑,🌑,🌑,🌑,🌑
|🌑,🌑,🌑,🌑,🌑,🌑,🌑,🌑,🌑,🌑,🌑,🌑,🌑,🌑,🌑,🌑,🌑,🌑,🌑,🌑,🌑,🌑,🌑,⚪️,🌑,🌑,🌑,🌑,🌑,🌑,🌑,🌑,🌑,🌑,🌑,🌑,🌑,🌑,🌑,🌑
|⚪️,🌑,🌑,🌑,🔲,🌑,🌑,🌑,🌑,🌑,🌑,🌑,🌑,🌑,🌑,🐚,🌑,🌑,🌑,🌑,🌑,🌑,🌑,🌑,🌑,🌑,🌑,🌑,🌑,🌑,🌑,⚪️,🌑,🌑,🌑,🌑,🌑,🌑,🌑,🌑
|🌑,🌑,🌑,🌑,🌑,🌑,🌑,🌑,🌑,🌑,🌑,🌑,🌑,🌑,🌑,🌑,🌑,🌑,🌑,🌑,🌑,🌑,🌑,🌑,🌑,🌑,🌑,🌑,🌑,🌑,🌑,🌑,🌑,🌑,🌑,🌑,🌑,🌑,🌑,🌑
|🔷,🔷,🔷,🌑,⚪️,🌑,🌑,🌑,🌑,🌑,🌑,🌑,🌑,🌑,🌑,🌑,🌑,🌑,🌑,🌑,🌑,🌑,🌑,🌑,🌑,🌑,🌑,🌑,🌑,🌑,🌑,🌑,🌑,🌑,🌑,🌑,🔷,🔷,🔷,⚪️
|🔷,🔷,🌑,🌑,🌑,🌑,🌑,⚪️,🌑,🌑,🌑,🌑,🛃,🌑,🌑,🌑,🌑,🌑,🌑,🌑,🌑,🌑,🌑,🌑,🌑,🌑,🌑,🌑,🌑,🌑,🌑,🌑,🌑,🌑,🌑,🌑,🌑,🔷,🔷,🌑
|🔷,🌑,🌑,🌑,🌑,🌑,🌑,🌑,🌑,🌑,🌑,🌑,🛃,🌑,🛃,🌑,🛃,🛃,🌑,🛃,🌑,🛃,🌑,🛃,🛃,🌑,🛃,🌑,🛃,🌑,🛃,🌑,🌑,🌑,🌑,🌑,🌑,🌑,🔷,🌑
|🌑,🌑,🌑,🌑,🔲,🌑,🌑,🌑,🌑,🌑,🛃,🌑,🌑,🌑,🌑,🌑,🌑,🌑,🛃,🌑,🛃,🌑,🛃,🌑,🌑,🌑,🌑,🌑,🌑,🌑,🛃,🌑,🌲,🌑,🌑,🌑,🌑,🌑,🌑,🌑
|🌑,⚪️,🌑,🌑,🌑,🌑,🌑,🌑,🌑,🌑,🌑,🌑,🛃,🌑,🛃,🌑,🛃,🌑,🛃,🌑,🛃,🌑,🛃,🌑,🛃,🌑,🛃,🌑,🛃,🌑,🛃,🌑,🌑,🌑,🌲,🌑,🌑,🌑,🌑,🌑
|🌑,🌑,🌑,🌑,🌑,🌑,🌑,🌑,🌑,🌑,🌑,🌑,🌑,🌑,🌑,🌑,🌑,🛃,🌑,🛃,🌑,🛃,🌑,🛃,🌑,🛃,🌑,🛃,🌑,🛃,🌑,✳️,🌑,🌑,🌑,🌑,🌑,🌑,🌑,🌑
|🌑,🌑,🌑,🌑,🌑,🌑,🌑,🌑,🌑,🌑,🛃,🌑,🌑,🌑,🛃,🌑,🛃,🌑,🌑,🌑,🛃,🚹,🌑,🚹,🌑,🛃,🌑,🌑,🌑,🛃,🌑,🌑,🌑,🌑,🌑,🌑,🌑,✳️,🌲,🌑
|🌑,🌑,🌑,🌑,🌑,🌑,🌑,🌑,🌑,🌑,🌑,🌑,🌑,🌑,🛃,🌑,🌑,🌑,🚹,🛃,🚹,🌑,🚹,🌑,🌑,🌑,🌑,🌑,🌑,🌑,🌑,🌑,🌑,🌑,🌲,🌑,🌑,🌑,🌑,🌑
|🌑,🌑,🌑,🔲,🌑,🌑,🌑,🌑,🌑,🌑,🌑,🌑,🌑,🌑,🌑,🌑,🌑,🌑,🌑,🛃,🌑,🌑,🌑,🌑,🌑,🌑,🌑,🌑,🌑,🌑,🌑,🌑,🌑,🌑,🌑,🌑,🌑,🌑,🌑,🌑
|🌑,🌑,🌑,🌑,🌑,🌑,🌑,🌑,🌑,🌑,🌑,🌑,🌑,🌑,🌑,🌑,🌑,🌑,🌑,🌑,🌑,🌑,🌑,🌑,🌑,🌑,⚪️,🌑,🌑,🌑,🌑,🌑,🌑,🌑,🌑,🌑,🌲,🌑,🌑,🌑
|🌑,🌑,🌑,🌑,🌑,🌑,🌑,🌑,🌑,🌑,🌑,🌑,🌑,🌑,🌑,🌑,🌑,🌑,🌑,🌑,🅿️,🌑,🌑,🌑,🌑,🌑,🌑,🌑,🌑,🌑,🌑,🌑,🌑,🌲,🌑,🌑,🌑,🌑,🌑,🌑
|🌑,🌑,⚪️,🌑,🌑,🌑,🌑,🌑,🌑,🌑,🌑,🌑,🌑,🌑,🌑,🌑,🌲,🌑,🌑,🌑,🌑,🌑,🌑,🌑,🌑,🌑,🌑,🌑,🌑,🌑,🌑,🌑,🌑,🌑,🌑,🌑,🌑,🌑,🌑,🌑
|🌑,🌑,🌑,🌑,🌑,🌑,🌑,🌑,🌑,🌑,🌑,🌑,🌑,🌑,🌑,🌑,🌑,🌑,🌑,🌑,🌑,🌑,🌑,🌑,🌑,🌑,🌑,🌑,🌑,🌑,🌑,🌑,🌑,🌑,🌑,✳️,🌑,🌲,🌑,🌑
|🌑,🌑,🌑,🌑,🌑,🌑,🌑,🌑,🌑,🌑,🌑,🌑,🌑,🌑,🌑,🌑,🌑,🌑,🌑,🌑,🌑,🌑,🌑,🌑,🌑,🌑,🌑,🌑,🌑,🌑,🌑,🌑,🌲,🌑,🌑,🌲,🌑,🌑,🌑,🌑
|🌑,🌑,🌑,🌑,🌑,🌑,🌑,🌑,🌑,🌑,🌑,🌑,🌑,🌑,🌑,🌑,🌑,🌑,🚹,🚹,🚹,🚹,🚹,🌑,🌑,🌑,🌑,🌑,🌑,🌑,🌑,🌑,🌑,🌑,🌑,🌑,🌑,🌑,🌑,🌑
|🌑,🌑,🌑,🌑,🌑,🌑,🌑,🌑,🌑,🌑,🌑,🌑,🌑,🌑,🌑,🌑,🌑,🌲,🌑,🌑,🌑,🌑,🌑,🌑,🌑,🌑,🌑,🌑,🌑,🌑,🌑,🌑,🌑,🌑,🌑,🌑,🌑,🌑,🌑,🌑
|🌑,🌑,🌑,🌑,🌑,🌑,🌑,🌑,🌑,🌑,🌑,🌑,🌑,🌑,🌑,🌑,🌑,🌑,🌑,🌑,🌑,🌑,🌑,🌑,🌑,🌑,🌑,🌑,🌑,🌑,🌑,🌑,🌑,🌑,🌑,🌑,🌑,🌑,🌑,🌑
|🌑,🌑,🌑,🔲,🌑,🌑,🌑,🌑,🌑,🌑,🌑,🌑,🌑,✳️,🌑,🌑,🌑,🌑,🌑,🌑,🌑,🌑,🌑,🌑,🌑,🌑,🌑,🌑,🌲,🌑,🌑,🔲,🌑,🌑,🌑,🌑,🌑,🌑,🌑,🌑
|🌑,🌑,🌑,🌑,🌑,🌑,🌑,🌑,🌑,🌑,🌑,🌑,🌑,🌑,🌑,🌑,🌑,🌑,🌑,🌑,🌑,🌑,🌑,🌑,🌑,⚪️,🌑,🌑,🌑,🌑,🌑,🌑,🌑,🌑,🌑,🌲,🌑,🌑,🌑,⚪️
|🔷,🌑,⚪️,🌑,🌑,⚪️,🌑,🌑,🌑,🌑,🌑,🌑,⚪️,🌑,🌑,🌑,🌲,🌑,🌑,🌑,🌑,⚪️,🌑,🌑,🌑,🌑,🌑,🌑,🌑,🌑,⚪️,🌑,🌑,⚪️,🌑,🌑,🌑,🌑,🔷,🌑
|🔷,🔷,🌑,🌑,🌑,🌑,🌑,🌑,🌑,⚪️,🌑,🌑,🌑,🌑,🌑,🌑,🌑,🌑,🌑,🌑,🌑,🌑,🌑,🌑,🌑,🌑,🌑,🌑,⚪️,🌑,🌑,🌑,🌑,🌑,🌑,🌑,🌑,🔷,🔷,⚪️
|🔷,🔷,🔷,🌑,🌑,🌑,🌑,🌑,🌑,🌑,🌑,🌑,🌑,🌑,🌑,🌑,🌑,🌑,🌑,🌑,🌑,🌑,🌑,🌑,🌑,🌑,🌑,🌑,🌑,🌑,🌑,🌑,🌑,🌑,🌑,🌑,🔷,🔷,🔷,🌑