🌑,🌑,🌑,🌑,🌑,🌑,🌑,🌑,🌑,🌑,🌑,🌑,🌑,🌑,🌑,🌑,🌑,🌑,🌑,🌑,🌑,🌑,🌑,🌑,🌑,🌑,🌑,🌑,🌑,🌑,🌑
|🌑,🌑,🌑,🌑,🌑,🌑,🌑,🌑,😊,🌑,🌑,🌑,😈,😈,🌑,🌑,🌑,🌑,🌑,🌑,🌑,🌑,🌑,🌑,🌑,🌑,🌑,🌑,🌑,🌑,🌑
|🌑,🌑,🌑,🌑,🌑,🌑,🌑,🌑,🌑,🌑,🌑,🌑,😈,😈,🌑,🌑,🌑,🌑,🌑,🌑,🌑,🌑,🌑,🌑,🌑,🌑,🌑,🌑,🌑,🌑,🌑
|🌑,🌑,🌑,🌑,🌑,🌑,🌑,🌑,😊,🌑,🔸,🌑,😈,😈,🌑,🌑,🌑,🌑,🌑,🌑,🌑,🌑,🌑,🌑,🌑,🌑,🌑,🌑,🌑,🌑,🌑
|🌑,🌑,🌑,🌑,🌑,🌑,🌑,🌑,🌑,🌑,🌑,🌑,😈,😈,🌑,🌑,🌑,🌑,🌑,🌑,🌑,🌑,🌑,🌑,🌑,🌑,🌑,🌑,🌑,🌑,🌑
|🌑,🌑,🌑,🌑,🌑,🌑,😇,🌑,😊,🌑,🌑,🌑,🌑,🌑,🌑,🌑,🌑,🌑,🌑,🌑,🌑,🌑,🌑,🌑,🌑,🌑,🌑,🌑,🌑,🌑,🌑
|🌑,🌑,🌑,🌑,🌑,🌑,🌑,🌑,🌑,🌑,🌑,🌑,🌑,🌑,🌑,🌑,🌑,🌑,🌑,🌑,🌑,🌑,🌑,🌑,🌑,🌑,🌑,🌑,🌑,🌑,🌑
|🌑,🌑,🌑,🌑,🌑,🌑,🌑,🌑,🌑,🌑,🌑,🌑,🌑,🌑,🌑,🌑,🌑,🌑,🌑,🌑,🌑,🌑,🌑,🌑,🌑,🌑,🌑,🌑,🌑,🌑,🌑
|🌑,🌑,🌑,🌑,🌑,🌑,🌑,🌑,😊,😊,😈,🌑,🌑,🌑,🌑,🌑,🌑,🌑,🌑,🌑,🌑,🌑,🌑,🌑,🌑,🌑,🌑,🌑,🌑,🌑,🌑
|🌑,🌑,🌑,🌑,🌑,🌑,🌑,🌑,😊,😊,😈,🌑,🌑,🌑,🌑,🌑,🌑,🌑,🌑,🌑,🌑,🌑,🌑,🌑,🌑,🌑,🌑,🌑,🌑,🌑,🌑
|🌑,🌑,🌑,🌑,🌑,🌑,🌑,🌑,😊,😊,😈,🌑,🌑,🌑,🌑,🌑,🌑,🌑,🌑,🌑,🌑,🌑,🌑,🌑,🌑,🌑,🌑,🌑,🌑,🌑,🌑
|🌑,🌑,🌑,🌑,🌑,🌑,🌑,🌑,😊,😊,😈,🌑,🌑,🌑,🌑,🌑,🌑,🌑,🌑,🌑,🌑,🌑,🌑,🌑,🌑,🌑,🌑,🌑,🌑,🌑,🌑
|🌑,🌑,🌑,🌑,🌑,🌑,🌑,🌑,🌑,🌑,🌑,🌑,🌑,🌑,🌑,🌑,🌑,🌑,🌑,🌑,🌑,🌑,🌑,🌑,🌑,🌑,🌑,🌑,🌑,🌑,🌑
|🌑,🌑,🌑,🌑,🌑,🌑,🌑,🌑,🌑,🌑,🌑,🌑,🌑,🌑,🌑,🌑,🌑,🌑,🌑,🌑,🌑,🌑,🌑,🌑,🌑,🌑,🌑,🌑,🌑,🌑,🌑
|🌑,🌑,🌑,🌑,🌑,🌑,🌑,🌑,🌑,🌑,🌑,🌑,🌑,🌑,🚰,🌑,🌑,🌑,🌑,🌑,🌑,🌑,🌑,🌑,🌑,🌑,🌑,🌑,🌑,🌑,🌑
|🌑,🌑,🌑,🌑,🌑,🌑,🌑,🌑,🌑,🌑,🌑,🌑,🌑,🌑,🌑,🌑,🌑,🌑,🌑,🌑,🌑,🌑,🌑,🌑,🌑,🌑,🌑,🌑,🌑,🌑,🌑
|🌑,🌑,🌑,🌑,🌑,🌑,🌑,🌑,🌑,🌑,🌑,🌑,🌑,🌑,🌑,🌑,🌑,🌑,🌑,🌑,🌑,🌑,🌑,🌑,🌑,🌑,🌑,🌑,🌑,🌑,🌑
|🌑,🌑,🌑,🌑,🌑,🌑,🌑,🌑,🌑,🌑,🌑,🌑,🌑,🌑,🌑,🌑,🌑,🌑,🌑,🌑,🌑,🌑,🌑,🌑,🌑,🌑,🌑,🌑,🌑,🌑,🌑
|🌑,🌑,🌑,🌑,🌑,🌑,🌑,🌑,😈,🌑,🌑,🌑,🌑,🌑,🌑,🌑,🌑,🌑,🌑,🌑,🌑,🌑,🌑,🌑,🌑,🌑,🌑,🌑,🌑,🌑,🌑
|🌑,🌑,🌑,🌑,🌑,🌑,🌑,🌑,🌑,🌑,🌑,🌑,🌑,🌑,🌑,🌑,🌑,🌑,🌑,🌑,🌑,🌑,🌑,🌑,🌑,🌑,🌑,🌑,🌑,🌑,🌑
|🌑,🌑,🌑,🌑,🌑,🌑,🌑,🌑,🌑,🌑,🌑,🌑,🌑,🌑,🌑,🌑,🌑,🌑,🌑,🌑,🌑,🌑,🌑,🌑,🌑,🌑,🌑,🌑,🌑,🌑,🌑
|🌑,🌑,🌑,🌑,🌑,🌑,🌑,🌑,🌑,🌑,🌑,🌑,🌑,🌑,🌑,🌑,🌑,🌑,🌑,🌑,🌑,🌑,🌑,🌑,🌑,🌑,🌑,🌑,🌑,🌑,🌑
|🌑,🌑,🌑,🌑,🌑,🌑,🌑,🌑,🌑,🌑,🌑,🌑,🌑,🌑,🌑,🌑,🌑,🌑,🌑,🌑,🌑,🌑,🌑,🌑,🌑,🌑,🌑,🌑,🌑,🌑,🌑
|🌑,🌑,🌑,🌑,🌑,🌑,🌑,🌑,🌑,🌑,🌑,🌑,🌑,🌑,🌑,🌑,🌑,🌑,🌑,🌑,🌑,🌑,🌑,🌑,🌑,🌑,🌑,🌑,🌑,🌑,🌑
|🌑,🌑,🌑,🌑,🌑,🌑,🌑,🌑,🌑,🌑,🌑,🌑,🌑,🌑,🌑,🌑,🌑,🌑,🌑,🌑,🌑,🌑,🌑,🌑,🌑,🌑,🌑,🌑,🌑,🌑,🌑
|🌑,🌑,🌑,🌑,🌑,🌑,🌑,🌑,🌑,🌑,🌑,🌑,🌑,🌑,🌑,🌑,🌑,🌑,🌑,🌑,🌑,🌑,🌑,🌑,🌑,🌑,🌑,🌑,🌑,🌑,🌑
|🌑,🌑,🌑,🌑,🌑,🌑,🌑,🌑,🌑,🌑,🌑,🌑,🌑,🌑,🌑,🌑,🌑,🌑,🌑,🌑,🌑,🌑,🌑,🌑,🌑,🌑,🌑,🌑,🌑,🌑,🌑
|🌑,🌑,🌑,🌑,🌑,🌑,🌑,🌑,🌑,🌑,🌑,🌑,🌑,🌑,🌑,🌑,🌑,🌑,🌑,🌑,🌑,🌑,🌑,🌑,🌑,🌑,🌑,🌑,🌑,🌑,🌑
|🌑,🌑,🌑,🌑,🌑,🌑,🌑,🌑,🌑,🌑,🌑,🌑,🌑,🌑,🌑,🌑,🌑,🌑,🌑,🌑,🌑,🌑,🌑,🌑,🌑,🌑,🌑,🌑,🌑,🌑,🌑
|🌑,🌑,🌑,🌑,🌑,🌑,🌑,🌑,🌑,🌑,🌑,🌑,🌑,🌑,🌑,🌑,🌑,🌑,🌑,🌑,🌑,🌑,🌑,🌑,🌑,🌑,🌑,🌑,🌑,🌑,🌑
|🌑,🌑,🌑,🌑,🌑,🌑,🌑,🌑,🌑,🌑,🌑,🌑,🌑,🌑,🌑,🌑,🌑,🌑,🌑,🌑,🌑,🌑,🌑,🌑,🌑,🌑,🌑,🌑,🌑,🌑,🌑
|🌑,🌑,🌑,🌑,🌑,🌑,🌑,🌑,🌑,🌑,🌑,🌑,🌑,🌑,🌑,🌑,🌑,🌑,🌑,🌑,🌑,🌑,🌑,🌑,🌑,🌑,🌑,🌑,🌑,🌑,🌑
|🌑,🌑,🌑,🌑,🌑,🌑,🌑,🌑,🌑,🌑,🌑,🌑,🌑,🌑,🌑,🌑,🌑,🌑,🌑,🌑,🌑,🌑,🌑,🌑,🌑,🌑,🌑,🌑,🌑,🌑,🌑
|🌑,🌑,🌑,🌑,🌑,🌑,🌑,🌑,🌑,🌑,🌑,🌑,🌑,🌑,🌑,🌑,🌑,🌑,🌑,🌑,🌑,🌑,🌑,🌑,🌑,🌑,🌑,🌑,🌑,🌑,🌑
|🌑,🌑,🌑,🌑,🌑,🌑,🌑,🌑,🌑,🌑,🌑,🌑,🌑,🌑,🌑,🌑,🌑,🌑,🌑,🌑,🌑,🌑,🌑,🌑,🌑,🌑,🌑,🌑,🌑,🌑,🌑
|🌑,🌑,🌑,🌑,🌑,🌑,🌑,🌑,🌑,🌑,🌑,🌑,🌑,🌑,🌑,🌑,🌑,🌑,🌑,🌑,🌑,🌑,🌑,🌑,🌑,🌑,🌑,🌑,🌑,🌑,🌑
|🌑,🌑,🌑,🌑,🌑,🌑,🌑,🌑,🌑,🌑,🌑,🌑,🌑,🌑,🌑,🌑,🌑,🌑,🌑,🌑,🌑,🌑,🌑,🌑,🌑,🌑,🌑,🌑,🌑,🌑,🌑
|🌑,🌑,🌑,🌑,🌑,🌑,🌑,🌑,🌑,🌑,🌑,🌑,🌑,🌑,🌑,🌑,🌑,🌑,🌑,🌑,🌑,🌑,🌑,🌑,🌑,🌑,🌑,🌑,🌑,🌑,🌑
|🌑,🌑,🌑,🌑,🌑,🌑,🌑,🌑,🌑,🌑,🌑,🌑,🌑,🌑,🌑,🌑,🌑,🌑,🌑,🌑,🌑,🌑,🌑,🌑,🌑,🌑,🌑,🌑,🌑,🌑,🌑
|🌑,🌑,🌑,🌑,🌑,🌑,🌑,🌑,🌑,🌑,🌑,🌑,🌑,🌑,🌑,🌑,🌑,🌑,🌑,🌑,🌑,🌑,🌑,🌑,🌑,🌑,🌑,🌑,🌑,🌑,🌑
|🌑,🌑,🌑,🌑,🌑,🌑,🌑,🌑,🌑,🌑,😈,🌑,🌑,🌑,🌑,🌑,🌑,🌑,🌑,🌑,🌑,🌑,🌑,🌑,🌑,🌑,🌑,🌑,🌑,🌑,🌑
|🌑,🌑,🌑,🌑,🌑,🌑,🌑,🌑,🌑,🌑,🌑,🌑,🌑,🌑,🌑,🌑,🌑,🌑,🌑,🌑,🌑,🌑,🌑,🌑,🌑,🌑,🌑,🌑,🌑,🌑,🌑
|🌑,🌑,🌑,🌑,🌑,🌑,🌑,🌑,🌑,🌑,🌑,🌑,🌑,🌑,🌑,🌑,🌑,🌑,🌑,🌑,🌑,🌑,🌑,🌑,🌑,🌑,🌑,🌑,🌑,🌑,🌑
|🌑,🌑,🌑,🌑,🌑,🌑,🌑,🌑,🌑,🌑,🌑,🌑,🌑,🌑,🌑,🌑,🌑,🌑,🌑,🌑,🌑,🌑,🌑,🌑,🌑,🌑,🌑,🌑,🌑,🌑,🌑
|🌑,🌑,🌑,🌑,🌑,🌑,🌑,🌑,🌑,🌑,🌑,🌑,🚹,🚹,🚹,🌑,🌑,🌑,🌑,🌑,🌑,🌑,🌑,🌑,🌑,🌑,🌑,🌑,🌑,🌑,🌑
|🌑,🌑,🌑,🌑,🌑,🌑,🌑,🌑,🌑,🌑,🌑,🌑,🌑,🌑,🌑,🌑,🌑,🌑,🌑,🌑,🌑,🌑,🌑,🌑,🌑,🌑,🌑,🌑,🌑,🌑,🌑
|🌑,🌑,🌑,🌑,🌑,🌑,🅱,🌑,🌑,🌑,🌑,🌑,🅰,🅰,🅰,🌑,🌑,🌑,🌑,🌑,🌑,🌑,🌑,🌑,🌑,🌑,🌑,🌑,🌑,🌑,🌑
|🌑,🌑,🌑,🌑,🌑,🌑,🌑,🌑,🌑,🌑,🌑,🌑,🌑,🌑,🌑,🌑,🌑,🌑,🌑,🌑,🌑,🌑,🌑,🌑,🌑,🌑,🌑,🌑,🌑,🌑,🌑
|🌑,🌑,🌑,🌑,🌑,🌑,🅱,🌑,🚹,🌑,🅰,🌑,🌑,🚹,🌑,🌑,🅰,🌑,🚹,🌑,🌑,🌑,🌑,🌑,🌑,🌑,🌑,🌑,🌑,🌑,🌑
|🌑,🌑,🌑,🌑,🌑,🌑,🌑,🌑,🚹,🌑,🅰,🌑,🚹,🚹,🚹,🌑,🅰,🌑,🚹,🌑,🌑,🌑,🌑,🌑,🌑,🌑,🌑,🌑,🌑,🌑,🌑
|🌑,🌑,🌑,🌑,🌑,🌑,🅱,🌑,🌑,🌑,🌑,🌑,🌑,🚹,🌑,🌑,🌑,🌑,🌑,🌑,🌑,🌑,🌑,🌑,🌑,🌑,🌑,🌑,🌑,🌑,🌑
|🌑,🌑,🌑,🌑,🌑,🌑,🌑,🌑,🚹,🌑,🅰,🌑,🌑,🚹,🌑,🌑,🌑,🌑,🌑,🌑,🌑,🌑,🌑,🌑,🌑,🌑,🌑,🌑,🌑,🌑,🌑
|🌑,🌑,🌑,🌑,🌑,🌑,🅱,🌑,🚹,🌑,🅰,🌑,🌑,🅿️,🌑,🌑,🅰,🌑,🚹,🌑,🌑,🌑,🌑,🌑,🌑,🌑,🌑,🌑,🌑,🌑,🌑
|🌑,🌑,🌑,🌑,🌑,🌑,🌑,🌑,🌑,🌑,🌑,🌑,🌑,🚹,🌑,🌑,🅰,🌑,🚹,🌑,🌑,🌑,🌑,🌑,🌑,🌑,🌑,🌑,🌑,🌑,🌑
|🌑,🌑,🌑,🌑,🌑,🌑,🌑,🌑,🚹,🌑,🅰,🌑,🌑,🚹,🌑,🌑,🌑,🌑,🌑,🌑,🌑,🌑,🌑,🌑,🌑,🌑,🌑,🌑,🌑,🌑,🌑
|🌑,🌑,🌑,🌑,🌑,🌑,🌑,🌑,🚹,🌑,🅰,🌑,🚹,🚹,🚹,🌑,🅰,🌑,🚹,🌑,🌑,🌑,🌑,🌑,🌑,🌑,🌑,🌑,🌑,🌑,🌑
|🌑,🌑,🌑,🌑,🌑,🌑,🌑,🌑,🌑,🌑,🌑,🌑,🌑,🚹,🌑,🌑,🅰,🌑,🚹,🌑,🌑,🌑,🌑,🌑,🌑,🌑,🌑,🌑,🌑,🌑,🌑
|🌑,🌑,🌑,🌑,🌑,🌑,🌑,🌑,🌑,🌑,🌑,🌑,🌑,🌑,🌑,🌑,🌑,🌑,🌑,🌑,🌑,🌑,🌑,🌑,🌑,🌑,🌑,🌑,🌑,🌑,🌑
|🌑,🌑,🌑,🌑,🌑,🌑,🌑,🌑,🌑,🌑,🌑,🌑,🅰,🅰,🅰,🌑,🌑,🌑,🌑,🌑,🌑,🌑,🌑,🌑,🌑,🌑,🌑,🌑,🌑,🌑,🌑
|🌑,🌑,🌑,🌑,🌑,🌑,🌑,🌑,🌑,🌑,🌑,🌑,🌑,🌑,🌑,🌑,🌑,🌑,🌑,🌑,🌑,🌑,🌑,🌑,🌑,🌑,🌑,🌑,🌑,🌑,🌑
|🌑,🌑,🌑,🌑,🌑,🌑,🌑,🌑,🌑,🌑,🌑,🌑,🚹,🚹,🚹,🌑,🌑,🌑,🌑,🌑,🌑,🌑,🌑,🌑,🌑,🌑,🌑,🌑,🌑,🌑,🌑
|🌑,🌑,🌑,🌑,🌑,🌑,🌑,🌑,🌑,🌑,🌑,🌑,🌑,🌑,🌑,🌑,🌑,🌑,🌑,🌑,🌑,🌑,🌑,🌑,🌑,🌑,🌑,🌑,🌑,🌑,🌑