|🌑,🌑,🌑,🌑,🌑,🌑,🌑,🌑,🌑,🌑,🌑,🌑,🌑,🌑,🌑,🌑,🌑,🌑,🌑,🌑,🌑,🌑,🌑,🌑,🌑,🌑,🌑,🌑,🌑,🌑,🌑,🌑,🌑,🌑,🌑,🌑,🌑,🌑,🌑,🌑,🌑,🌑,🌑,🌑,🌑,🌑,🌑,🌑,🌑,🌑,🌑,🌑,🌑,🌑,🌑,🌑,🌑,🌑,🌑,🌑,🌑,🌑,🌑
|⬇️,🌑,🌑,🌑,🌑,🌑,🌑,⬇️,🌑,🌑,🌑,🌑,🌑,🌑,🌑,⬇️,🌑,🌑,🌑,🌑,🌑,⬇️,🌑,🌑,🌑,🌑,🌑,🌑,🌑,🌑,🌑,⬇️,🌑,🌑,🌑,🌑,🌑,🌑,🌑,⬇️,🌑,🌑,🌑,🌑,🌑,🌑,⬇️,🌑,🌑,🌑,🌑,🌑,🌑,🌑,🌑,🌑,🌑,🌑,⬇️,🌑,🌑,🌑,🌑
|🌑,🌑,🌑,🌑,🌑,🌑,🌑,🌑,🌑,🌑,🌑,🌑,🌑,🌑,🌑,🌑,🌑,🌑,🌑,🌑,🌑,🌑,🌑,🌑,🌑,🌑,🌑,🌑,🌑,🌑,🌑,🌑,🌑,🌑,🌑,🌑,🌑,🌑,🌑,🌑,🌑,🌑,🌑,🌑,🌑,🌑,🌑,🌑,🌑,🌑,🌑,🌑,🌑,🌑,🌑,🌑,🌑,🌑,🌑,🌑,🌑,🌑,🌑
|🌑,🌑,🌑,🌑,🌑,🌑,🌑,🌑,🌑,🌑,🌑,🌑,🌑,🌑,🌑,🌑,🌑,🌑,🌑,🌑,🌑,🌑,🌑,🌑,🌑,🌑,🌑,🌑,🌑,🌑,🌑,🌑,🌑,🌑,🌑,🌑,🌑,🌑,🌑,🌑,🌑,🌑,🌑,🌑,🌑,🌑,🌑,🌑,🌑,🌑,🌑,🌑,🌑,🌑,🌑,🌑,🌑,🌑,🌑,🌑,🌑,🌑,🌑
|🌑,🌑,🌑,🌑,🌑,🌑,🌑,🌑,🌑,🌑,🌑,🌑,🌑,🌑,🌑,🌑,🌑,🌑,🌑,🌑,🌑,🌑,🌑,🌑,🌑,🌑,🌑,🌑,🌑,🌑,🌑,🌑,🌑,🌑,🌑,🌑,🌑,🌑,🌑,🌑,🌑,🌑,🌑,🌑,🌑,🌑,🌑,🌑,🌑,🌑,🌑,🌑,🌑,🌑,🌑,🌑,🌑,🌑,🌑,🌑,🌑,🌑,🌑
|🌑,🌑,🌑,🌑,🌑,🌑,🌑,🌑,🌑,🌑,🌑,🌑,🌑,🌑,🌑,🌑,🌑,🌑,🌑,🌑,🌑,🌑,🌑,🌑,🌑,🌑,🌑,🌑,🌑,🌑,🌑,🌑,🌑,🌑,🌑,🌑,🌑,🌑,🌑,🌑,🌑,🌑,🌑,🌑,🌑,🌑,🌑,🌑,🌑,🌑,🌑,🌑,🌑,🌑,🌑,🌑,🌑,🌑,🌑,🌑,🌑,🌑,🌑
|🌑,🌑,🌑,🌑,🌑,🌑,🌑,🌑,🌑,🌑,🌑,🌑,🌑,🌑,🌑,🌑,🌑,🌑,🌑,🌑,🌑,🌑,🌑,🌑,🌑,🌑,🌑,🌑,🌑,🌑,🌑,🌑,🌑,🌑,🌑,🌑,🌑,🌑,🌑,🌑,🌑,🌑,🌑,🌑,🌑,🌑,🌑,🌑,🌑,🌑,🌑,🌑,🌑,🌑,🌑,🌑,🌑,🌑,🌑,🌑,🌑,🌑,🌑
|🌑,🌑,🌑,🌑,🌑,🌑,🌑,🌑,🌑,🌑,🌑,🌑,🌑,🌑,🌑,🌑,🌑,🌑,🌑,🌑,🌑,🌑,🌑,🌑,🌑,🌑,🌑,🌑,🌑,🌑,🌑,🌑,🌑,🌑,🌑,🌑,🌑,🌑,🌑,🌑,🌑,🌑,🌑,🌑,🌑,🌑,🌑,🌑,🌑,🌑,🌑,🌑,🌑,🌑,🌑,🌑,🌑,🌑,🌑,🌑,🌑,🌑,🌑
|🌑,🌑,🌑,🌑,🌑,🌑,🌑,🌑,🌑,🌑,🌑,🌑,🌑,🌑,🌑,🌑,🌑,🌑,🌑,🌑,🌑,🌑,🌑,🌑,🌑,🌑,🌑,🌑,🌑,🌑,🌑,🌑,🌑,🌑,🌑,🌑,🌑,🌑,🌑,🌑,🌑,🌑,🌑,🌑,🌑,🌑,🌑,🌑,🌑,🌑,🌑,🌑,🌑,🌑,🌑,🌑,🌑,🌑,🌑,🌑,🌑,🌑,🌑
|🌑,🌑,🌑,🌑,🌑,🌑,🌑,🌑,🌑,🌑,🌑,🌑,🌑,🌑,🌑,🌑,🌑,🌑,🌑,🌑,🌑,🌑,🌑,🌑,🌑,🌑,🌑,🌑,🌑,🌑,🌑,🌑,🌑,🌑,🌑,🌑,🌑,🌑,🌑,🌑,🌑,🌑,🌑,🌑,🌑,🌑,🌑,🌑,🌑,🌑,🌑,🌑,🌑,🌑,🌑,🌑,🌑,🌑,🌑,🌑,🌑,🌑,🌑
|🌑,🌑,🌑,🌑,🌑,🌑,🌑,🌑,🌑,🌑,🌑,🌑,🌑,🌑,🌑,🌑,🌑,🌑,🌑,🌑,🌑,🌑,🌑,🌑,🌑,🌑,🌑,🌑,🌑,🌑,🌑,🌑,🌑,🌑,🌑,🌑,🌑,🌑,🌑,🌑,🌑,🌑,🌑,🌑,🌑,🌑,🌑,🌑,🌑,🌑,🌑,🌑,🌑,🌑,🌑,🌑,🌑,🌑,🌑,🌑,🌑,🌑,🌑
|🌑,🌑,🌑,🌑,🌑,🌑,🌑,🌑,🌑,🌑,🌑,🌑,🌑,🌑,🌑,🌑,🌑,🌑,🌑,🌑,🌑,🌑,🌑,🌑,🌑,🌑,🌑,🌑,🌑,🌑,🌑,🌑,🌑,🌑,🌑,🌑,🌑,🌑,🌑,🌑,🌑,🌑,🌑,🌑,🌑,🌑,🌑,🌑,🌑,🌑,🌑,🌑,🌑,🌑,🌑,🌑,🌑,🌑,🌑,🌑,🌑,🌑,🌑
|🌑,⬛️,🌑,🌑,🌑,🌑,🌑,🌑,🌑,🌑,🌑,🌑,🌑,🌑,🌑,⬛️,🌑,🌑,🌑,🌑,🌑,🌑,🌑,🌑,⬛️,🌑,🌑,🌑,🌑,🌑,🌑,⬛️,🌑,🌑,🌑,🌑,🌑,🌑,🌑,🌑,🌑,🌑,🌑,🌑,🌑,🌑,⬛️,🌑,🌑,🌑,🌑,🌑,🌑,🌑,🌑,🌑,🌑,🌑,⬛️,🌑,🌑,🌑,🌑
|🌑,🌑,🌑,🌑,🌑,🌑,🌑,🌑,🌑,🌑,🌑,🌑,🌑,🌑,🌑,🌑,🌑,🌑,🌑,🌑,🌑,🌑,🌑,🌑,🌑,🌑,🌑,🌑,🌑,🌑,🌑,🌑,🌑,🌑,🌑,🌑,🌑,🌑,🌑,🌑,🌑,🌑,🌑,🌑,🌑,🌑,🌑,🌑,🌑,🌑,🌑,🌑,🌑,🌑,🌑,🌑,🌑,🌑,🌑,🌑,🌑,🌑,🌑
|🌑,🌑,🌑,🌑,🌑,🌑,🌑,🌑,🌑,🌑,🌑,🌑,🌑,🌑,🌑,🌑,🌑,🌑,🌑,🌑,🌑,🌑,🌑,🌑,🌑,🌑,🌑,🌑,🌑,🌑,🌑,🌑,🌑,🌑,🌑,🌑,🌑,🌑,🌑,🌑,🌑,🌑,🌑,🌑,🌑,🌑,🌑,🌑,🌑,🌑,🌑,🌑,🌑,🌑,🌑,🌑,🌑,🌑,🌑,🌑,🌑,🌑,🌑
|🌑,🌑,🌑,🌑,🌑,🌑,🌑,🌑,🌑,🌑,🌑,🌑,🌑,🌑,🌑,🌑,🌑,🌑,🌑,🌑,🌑,🌑,🌑,🌑,🌑,🌑,🌑,🌑,🌑,🌑,🌑,🌑,🌑,🌑,🌑,🌑,🌑,🌑,🌑,🌑,🌑,🌑,🌑,🌑,🌑,🌑,🌑,🌑,🌑,🌑,🌑,🌑,🌑,🌑,🌑,🌑,🌑,🌑,🌑,🌑,🌑,🌑,🌑
|🌑,🌑,🌑,🌑,🌑,🌑,🌑,🌑,🌑,🌑,🌑,🌑,🌑,🌑,🌑,🌑,🌑,🌑,🌑,🌑,🌑,🌑,🌑,🌑,🌑,🌑,🌑,🌑,🌑,🌑,🌑,🌑,🌑,🌑,🌑,🌑,🌑,🌑,🌑,🌑,🌑,🌑,🌑,🌑,🌑,🌑,🌑,🌑,🌑,🌑,🌑,🌑,🌑,🌑,🌑,🌑,🌑,🌑,🌑,🌑,🌑,🌑,🌑
|🌑,🌑,🌑,🌑,🌑,🌑,🌑,🌑,🌑,🌑,🌑,🌑,🌑,🌑,🌑,🌑,🌑,🌑,🌑,🌑,🌑,🌑,🌑,🌑,🌑,🌑,🌑,🌑,🌑,🌑,🌑,🌑,🌑,🌑,🌑,🌑,🌑,🌑,🌑,🌑,🌑,🌑,🌑,🌑,🌑,🌑,🌑,🌑,🌑,🌑,🌑,🌑,🌑,🌑,🌑,🌑,🌑,🌑,🌑,🌑,🌑,🌑,🌑
|🌑,🌑,🌑,🌑,🌑,🌑,🌑,🌑,🌑,🌑,🌑,🌑,🌑,🌑,🌑,🌑,🌑,🌑,🌑,🌑,🌑,🌑,🌑,🌑,🌑,🌑,🌑,🌑,🌑,🌑,🌑,🌑,🌑,🌑,🌑,🌑,🌑,🌑,🌑,🌑,🌑,🌑,🌑,🌑,🌑,🌑,🌑,🌑,🌑,🌑,🌑,🌑,🌑,🌑,🌑,🌑,🌑,🌑,🌑,🌑,🌑,🌑,🌑
|🌑,🌑,🌑,🌑,🌑,🌑,🌑,🌑,🌑,🌑,🌑,🌑,🌑,🌑,🌑,🌑,🌑,🌑,🌑,🌑,🌑,🌑,🌑,🌑,🌑,🌑,🌑,🌑,🌑,🌑,🌑,🌑,🌑,🌑,🌑,🌑,🌑,🌑,🌑,🌑,🌑,🌑,🌑,🌑,🌑,🌑,🌑,🌑,🌑,🌑,🌑,🌑,🌑,🌑,🌑,🌑,🌑,🌑,🌑,🌑,🌑,🌑,🌑
|🌑,🌑,🌑,🌑,🌑,🌑,🌑,🌑,🌑,🌑,🌑,🌑,🌑,🌑,🌑,🌑,🌑,🌑,🌑,🌑,🌑,🌑,🌑,🌑,🌑,🌑,🌑,🌑,🌑,🌑,🌑,🌑,🌑,🌑,🌑,🌑,🌑,🌑,🌑,🌑,🌑,🌑,🌑,🌑,🌑,🌑,🌑,🌑,🌑,🌑,🌑,🌑,🌑,🌑,🌑,🌑,🌑,🌑,🌑,🌑,🌑,🌑,🌑
|🌑,🌑,🌑,🌑,🌑,🌑,🌑,🌑,🌑,🌑,🌑,🌑,🌑,🌑,🌑,⬛️,🌑,🌑,🌑,🌑,🌑,🌑,🌑,🌑,⬛️,🌑,🌑,🌑,🌑,🌑,🌑,⬛️,🌑,🌑,🌑,🌑,🌑,🌑,🌑,🌑,🌑,🌑,🌑,🌑,🌑,🌑,⬛️,🌑,🌑,🌑,🌑,🌑,🌑,🌑,🌑,🌑,🌑,🌑,⬛️,🌑,🌑,🌑,🌑
|🌑,⬛️,🌑,🌑,🌑,🌑,🌑,🌑,🌑,🌑,🌑,🌑,🌑,🌑,🌑,🌑,🌑,🌑,🌑,🌑,🌑,🌑,🌑,🌑,🌑,🌑,🌑,🌑,🌑,🌑,🌑,🌑,🌑,🌑,🌑,🌑,🌑,🌑,🌑,🌑,🌑,🌑,🌑,🌑,🌑,🌑,🌑,🌑,🌑,🌑,🌑,🌑,🌑,🌑,🌑,🌑,🌑,🌑,🌑,🌑,🌑,🌑,🌑
|🌑,🌑,🌑,🌑,🌑,🌑,🌑,🌑,🌑,🌑,🌑,🌑,🌑,🌑,🌑,🌑,🌑,🌑,🌑,🌑,🌑,🌑,🌑,🌑,🌑,🌑,🌑,🌑,🌑,🌑,🌑,🌑,🌑,🌑,🌑,🌑,🌑,🌑,🌑,🌑,🌑,🌑,🌑,🌑,🌑,🌑,🌑,🌑,🌑,🌑,🌑,🌑,🌑,🌑,🌑,🌑,🌑,🌑,🌑,🌑,🌑,🌑,🌑
|🌑,🌑,🌑,🌑,🌑,🌑,🌑,🌑,🌑,🌑,🌑,🌑,🌑,🌑,🌑,🌑,🌑,🌑,🌑,🌑,🌑,🌑,🌑,🌑,🌑,🌑,🌑,🌑,🌑,🌑,🌑,🌑,🌑,🌑,🌑,🌑,🌑,🌑,🌑,🌑,🌑,🌑,🌑,🌑,🌑,🌑,🌑,🌑,🌑,🌑,🌑,🌑,🌑,🌑,🌑,🌑,🌑,🌑,🌑,🌑,🌑,🌑,🌑
|🌑,🌑,🌑,🌑,🌑,🌑,🌑,🌑,🌑,🌑,🌑,🌑,🌑,🌑,🌑,🌑,🌑,🌑,🌑,🌑,🌑,🌑,🌑,🌑,🌑,🌑,🌑,🌑,🌑,🌑,🌑,🌑,🌑,🌑,🌑,🌑,🌑,🌑,🌑,🌑,🌑,🌑,🌑,🌑,🌑,🌑,🌑,🌑,🌑,🌑,🌑,🌑,🌑,🌑,🌑,🌑,🌑,🌑,🌑,🌑,🌑,🌑,🌑
|🌑,🌑,🌑,🌑,🌑,🌑,🌑,🌑,🌑,🌑,🌑,🌑,🌑,🌑,🌑,🌑,🌑,🌑,🌑,🌑,🌑,🌑,🌑,🌑,🌑,🌑,🌑,🌑,🌑,🌑,🌑,🌑,🌑,🌑,🌑,🌑,🌑,🌑,🌑,🌑,🌑,🌑,🌑,🌑,🌑,🌑,🌑,🌑,🌑,🌑,🌑,🌑,🌑,🌑,🌑,🌑,🌑,🌑,🌑,🌑,🌑,🌑,🌑
|🌑,🌑,🌑,🌑,🌑,🌑,🌑,🌑,🌑,🌑,🌑,🌑,🌑,🌑,🌑,🌑,🌑,🌑,🌑,🌑,🌑,🌑,🌑,🌑,🌑,🌑,🌑,🌑,🌑,🌑,🌑,🌑,🌑,🌑,🌑,🌑,🌑,🌑,🌑,🌑,🌑,🌑,🌑,🌑,🌑,🌑,🌑,🌑,🌑,🌑,🌑,🌑,🌑,🌑,🌑,🌑,🌑,🌑,🌑,🌑,🌑,🌑,🌑
|🌑,⬛️,🌑,🌑,🌑,🌑,🌑,🌑,🌑,🌑,🌑,🌑,🌑,🌑,🌑,⬛️,🌑,🌑,🌑,🌑,🌑,🌑,🌑,🌑,⬛️,🌑,🌑,🌑,🌑,🌑,🌑,⬛️,🌑,🌑,🌑,🌑,🌑,🌑,🌑,🌑,🌑,🌑,🌑,🌑,🌑,🌑,⬛️,🌑,🌑,🌑,🌑,🌑,🌑,🌑,🌑,🌑,🌑,🌑,⬛️,🌑,🌑,🌑,🌑
|🌑,🌑,🌑,🌑,🌑,🌑,🌑,🌑,🌑,🌑,🌑,🌑,🌑,🌑,🌑,🌑,🌑,🌑,🌑,🌑,🌑,🌑,🌑,🌑,🌑,🌑,🌑,🌑,🌑,🌑,🌑,🌑,🌑,🌑,🌑,🌑,🌑,🌑,🌑,🌑,🌑,🌑,🌑,🌑,🌑,🌑,🌑,🌑,🌑,🌑,🌑,🌑,🌑,🌑,🌑,🌑,🌑,🌑,🌑,🌑,🌑,🌑,🌑
|🌑,🌑,🌑,🌑,🌑,🌑,🌑,🌑,🌑,🌑,🌑,🌑,🌑,🌑,🌑,🌑,🌑,🌑,🌑,🌑,🌑,🌑,🌑,🌑,🌑,🌑,🌑,🌑,🌑,🌑,🌑,🌑,🌑,🌑,🌑,🌑,🌑,🌑,🌑,🌑,🌑,🌑,🌑,🌑,🌑,🌑,🌑,🌑,🌑,🌑,🌑,🌑,🌑,🌑,🌑,🌑,🌑,🌑,🌑,🌑,🌑,🌑,🌑
|🌑,🌑,🌑,🌑,🌑,🌑,🌑,🌑,🌑,🌑,🌑,🌑,🌑,🌑,🌑,🌑,🌑,🌑,🌑,🌑,🌑,🌑,🌑,🌑,🌑,🌑,🌑,🌑,🌑,🌑,🌑,🌑,🌑,🌑,🌑,🌑,🌑,🌑,🌑,🌑,🌑,🌑,🌑,🌑,🌑,🌑,🌑,🌑,🌑,🌑,🌑,🌑,🌑,🌑,🌑,🌑,🌑,🌑,🌑,🌑,🌑,🌑,🌑
|🌑,🌑,🌑,🌑,🌑,🌑,🌑,🌑,🌑,🌑,🌑,🌑,🌑,🌑,🌑,🌑,🌑,🌑,🌑,🌑,🌑,🌑,🌑,🌑,🌑,🌑,🌑,🌑,🌑,🌑,🌑,🌑,🌑,🌑,🌑,🌑,🌑,🌑,🌑,🌑,🌑,🌑,🌑,🌑,🌑,🌑,🌑,🌑,🌑,🌑,🌑,🌑,🌑,🌑,🌑,🌑,🌑,🌑,🌑,🌑,🌑,🌑,🌑
|🌑,🌑,🌑,🌑,🌑,🌑,🌑,🌑,🌑,🌑,🌑,🌑,🌑,🌑,🌑,🌑,🌑,🌑,🌑,🌑,🌑,🌑,🌑,🌑,🌑,🌑,🌑,🌑,🌑,🌑,🌑,🌑,🌑,🌑,🌑,🌑,🌑,🌑,🌑,🌑,🌑,🌑,🌑,🌑,🌑,🌑,🌑,🌑,🌑,🌑,🌑,🌑,🌑,🌑,🌑,🌑,🌑,🌑,🌑,🌑,🌑,🌑,🌑
|🌑,🌑,🌑,🌑,🌑,🌑,🌑,🌑,🌑,🌑,🌑,🌑,🌑,🌑,🌑,🌑,🌑,🌑,🌑,🌑,🌑,🌑,🌑,🌑,🌑,🌑,🌑,🌑,🌑,🌑,🌑,🌑,🌑,🌑,🌑,🌑,🌑,🌑,🌑,🌑,🌑,🌑,🌑,🌑,🌑,🌑,🌑,🌑,🌑,🌑,🌑,🌑,🌑,🌑,🌑,🌑,🌑,🌑,🌑,🌑,🌑,🌑,🌑
|🌑,🌑,🌑,🌑,🌑,🌑,🌑,🌑,🌑,🌑,🌑,🌑,🌑,🌑,🌑,🌑,🌑,🌑,🌑,🌑,🌑,🌑,🌑,🌑,🌑,🌑,🌑,🌑,🌑,🌑,🌑,🌑,🌑,🌑,🌑,🌑,🌑,🌑,🌑,🌑,🌑,🌑,🌑,🌑,🌑,🌑,🌑,🌑,🌑,🌑,🌑,🌑,🌑,🌑,🌑,🌑,🌑,🌑,🌑,🌑,🌑,🌑,🌑
|🌑,🌑,🌑,🌑,🌑,🌑,🌑,🌑,🌑,🌑,🌑,🌑,🌑,🌑,🌑,🌑,🌑,🌑,🌑,🌑,🌑,🌑,🌑,🌑,🌑,🌑,🌑,🌑,🌑,🌑,🌑,🌑,🌑,🌑,🌑,🌑,🌑,🌑,🌑,🌑,🌑,🌑,🌑,🌑,🌑,🌑,🌑,🌑,🌑,🌑,🌑,🌑,🌑,🌑,🌑,🌑,🌑,🌑,🌑,🌑,🌑,🌑,🌑
|🌑,🌑,🌑,🌑,🌑,🌑,🌑,🌑,🌑,🌑,🌑,🌑,🌑,🌑,🌑,⬛️,🌑,🌑,🌑,🌑,🌑,🌑,🌑,🌑,⬛️,🌑,🌑,🌑,🌑,🌑,🌑,⬛️,🌑,🌑,🌑,🌑,🌑,🌑,🌑,🌑,🌑,🌑,🌑,🌑,🌑,🌑,⬛️,🌑,🌑,🌑,🌑,🌑,🌑,🌑,🌑,🌑,🌑,🌑,⬛️,🌑,🌑,🌑,🌑
|🌑,⬛️,🌑,🌑,🌑,🌑,🌑,🌑,🌑,🌑,🌑,🌑,🌑,🌑,🌑,🌑,🌑,🌑,🌑,🌑,🌑,🌑,🌑,🌑,🌑,🌑,🌑,🌑,🌑,🌑,🌑,🌑,🌑,🌑,🌑,🌑,🌑,🌑,🌑,🌑,🌑,🌑,🌑,🌑,🌑,🌑,🌑,🌑,🌑,🌑,🌑,🌑,🌑,🌑,🌑,🌑,🌑,🌑,🌑,🌑,🌑,🌑,🌑
|🌑,🌑,🌑,🌑,🌑,🌑,🌑,🌑,🌑,🌑,🌑,🌑,🌑,🌑,🌑,🌑,🌑,🌑,🌑,🌑,🌑,🌑,🌑,🌑,🌑,🌑,🌑,🌑,🌑,🌑,🌑,🌑,🌑,🌑,🌑,🌑,🌑,🌑,🌑,🌑,🌑,🌑,🌑,🌑,🌑,🌑,🌑,🌑,🌑,🌑,🌑,🌑,🌑,🌑,🌑,🌑,🌑,🌑,🌑,🌑,🌑,🌑,🌑
|🌑,🌑,🌑,🌑,🌑,🌑,🌑,🌑,🌑,🌑,🌑,🌑,🌑,🌑,🌑,🌑,🌑,🌑,🌑,🌑,🌑,🌑,🌑,🌑,🌑,🌑,🌑,🌑,🌑,🌑,🌑,🌑,🌑,🌑,🌑,🌑,🌑,🌑,🌑,🌑,🌑,🌑,🌑,🌑,🌑,🌑,🌑,🌑,🌑,🌑,🌑,🌑,🌑,🌑,🌑,🌑,🌑,🌑,🌑,🌑,🌑,🌑,🌑
|🌑,🌑,🌑,🌑,🌑,🌑,🌑,🌑,🌑,🌑,🌑,🌑,🌑,🌑,🌑,🌑,🌑,🌑,🌑,🌑,🌑,🌑,🌑,🌑,🌑,🌑,🌑,🌑,🌑,🌑,🌑,🌑,🌑,🌑,🌑,🌑,🌑,🌑,🌑,🌑,🌑,🌑,🌑,🌑,🌑,🌑,🌑,🌑,🌑,🌑,🌑,🌑,🌑,🌑,🌑,🌑,🌑,🌑,🌑,🌑,🌑,🌑,🌑
|🌑,🌑,🌑,🌑,🌑,🌑,🌑,🌑,🌑,🌑,🌑,🌑,🌑,🌑,🌑,🌑,🌑,🌑,🌑,🌑,🌑,🌑,🌑,🌑,🌑,🌑,🌑,🌑,🌑,🌑,🌑,🌑,🌑,🌑,🌑,🌑,🌑,🌑,🌑,🌑,🌑,🌑,🌑,🌑,🌑,🌑,🌑,🌑,🌑,🌑,🌑,🌑,🌑,🌑,🌑,🌑,🌑,🌑,🌑,🌑,🌑,🌑,🌑
|🌑,🌑,🌑,🌑,🌑,🌑,🌑,🌑,🌑,🌑,🌑,🌑,🌑,🌑,🌑,🌑,🌑,🌑,🌑,🌑,🌑,🌑,🌑,🌑,🌑,🌑,🌑,🌑,🌑,🌑,🌑,🌑,🌑,🌑,🌑,🌑,🌑,🌑,🌑,🌑,🌑,🌑,🌑,🌑,🌑,🌑,🌑,🌑,🌑,🌑,🌑,🌑,🌑,🌑,🌑,🌑,🌑,🌑,🌑,🌑,🌑,🌑,🌑
|🌑,🌑,🌑,🌑,🌑,🌑,🌑,🌑,🌑,🌑,🌑,🌑,🌑,🌑,🌑,🌑,🌑,🌑,🌑,🌑,🌑,🌑,🌑,🌑,🌑,🌑,🌑,🌑,🌑,🌑,🌑,✳️,🌑,🌑,🌑,🌑,🌑,🌑,🌑,🌑,🌑,🌑,🌑,🌑,🌑,🌑,✳️,🌑,🌑,🌑,🌑,🌑,🌑,🌑,🌑,🌑,🌑,🌑,🌑,🌑,🌑,🌑,✳️
|🌑,🌑,🌑,🌑,🌑,🌑,🌑,🌑,🌑,🌑,🌑,🌑,🌑,🌑,🌑,✳️,🌑,🌑,🌑,🌑,🌑,🌑,🌑,🌑,🌑,🌑,🌑,🌑,🌑,🌑,🌑,🌑,🌑,🌑,🌑,🌑,🌑,🌑,🌑,🌑,🌑,🌑,🌑,🌑,🌑,🌑,🌑,🌑,🌑,🌑,🌑,🌑,🌑,🌑,🌑,🌑,🌑,🌑,🌑,🌑,🌑,🌑,🌑
|🌑,🌑,🌑,🌑,🌑,🌑,🐚,🌑,🌑,🌑,🌑,🌑,🌑,🌑,🌑,🌑,🌑,🌑,🌑,🌑,🌑,🌑,🌑,🌑,🌑,🌑,🌑,🌑,🌑,🌑,🌑,🌑,🌑,🌑,🌑,🌑,🌑,🌑,🌑,🌑,🌑,🌑,🌑,🌑,🌑,🌑,🌑,🌑,🌑,🌑,🌑,🌑,🌑,🌑,🌑,🌑,🌑,🌑,🌑,🌑,🌑,🌑,🌑
|🌑,🌑,🌑,🌑,🌑,🌑,🌑,🌑,🌑,🌑,🌑,🌑,🌑,🌑,🌑,🌑,🌑,🌑,🌑,🌑,🌑,🌑,🌑,🌑,🌑,🌑,🌑,🌑,🌑,🌑,🌑,🌑,🌑,🌑,🌑,🌑,🌑,🌑,🌑,🌑,🌑,🌑,🌑,🌑,🌑,🌑,🌑,🌑,🌑,🌑,🌑,🌑,🌑,🌑,🌑,🌑,🌑,🌑,🌑,🌑,🌑,🌑,🌑
|🌑,🌑,🌑,🌑,🌑,🌑,🌑,🌑,🌑,🌑,🌑,🌑,🌑,🌑,🌑,🌑,🌑,🌑,🌑,🌑,🌑,🌑,🌑,🌑,🌑,🌑,🌑,🌑,🌑,🌑,🌑,🌑,🌑,🌑,🌑,🌑,🌑,🌑,🌑,🌑,🌑,🌑,🌑,🌑,🌑,🌑,🌑,🌑,🌑,🌑,🌑,🌑,🌑,🌑,🌑,🌑,🌑,🌑,🌑,🌑,🌑,🌑,🌑
|⚪️,🌑,🌑,🌑,✳️,🌑,🌑,🌑,🌑,🌑,🌑,🌑,🌑,🌑,🌑,🐚,🌑,🌑,🌑,🌑,🌑,🌑,🌑,🌑,🌑,🌑,🌑,🌑,🌑,🌑,🌑,⚪️,🌑,🌑,🌑,🌑,🌑,🌑,🌑,🌑,🌑,🌑,🌑,🌑,🌑,🌑,🌑,🌑,🌑,🌑,🌑,🌑,🌑,🌑,🌑,🌑,🌑,🌑,🌑,🌑,🌑,🌑,🌑
|🌑,🌑,🌑,🌑,🌑,🌑,🌑,🌑,🌑,🌑,🌑,🌑,🌑,🌑,🌑,🌑,🌑,🌑,🌑,🌑,🌑,🌑,🌑,🌑,🌑,🌑,🌑,🌑,🌑,🌑,🌑,🌑,🌑,🌑,🌑,🌑,🌑,🌑,🌑,🌑,🌑,🌑,🌑,🌑,🌑,🌑,🌑,🌑,🌑,🌑,🌑,🌑,🌑,🌑,🌑,🌑,🌑,🌑,🌑,🌑,🌑,🌑,🌑
|🌑,🌑,🌑,🌑,🌲,🌑,🌑,🌑,🌑,🌑,🌑,🌑,🌑,🌑,🌑,🌑,🌑,🌑,🌑,🌑,🌑,🌑,🌑,🌑,🌑,🌑,🌑,🌑,🌑,🌑,🌑,🌑,🌑,🌑,🌑,🌑,🌑,🌑,🌑,🌑,🌑,🌑,🌑,🌑,🌑,🌑,🌑,🌑,🌑,🌑,🌑,🌑,🌑,🌑,🌑,🌑,🌑,🌑,🌑,🌑,🌑,🌑,🌑
|🌑,🌑,🌑,🌑,🌑,🌑,🌑,🌲,🌑,🌑,🌑,🌑,🌑,🌑,🌑,🌑,🌑,🌑,🌑,🌑,🌑,🌑,🌑,🌑,🌑,🌑,🌑,🌑,🌑,🌑,🌑,🌑,🌑,🌑,🌑,🌑,🌑,🌑,🌑,🌑,🌑,🌑,🌑,🌑,🌑,🌑,🌑,🌑,🌑,🌑,🌑,🌑,🌑,🌑,🌑,🌑,🌑,🌑,🌑,🌑,🌑,🌑,🌑
|🌑,🌑,🌑,🌑,🌑,🌑,🌑,🌑,🌑,🌑,🌑,🌑,🌑,🌑,🌑,🌑,🌑,🌑,🌑,🌑,🌑,🌑,🌑,🌑,🌑,🌑,🌑,🌑,🌑,🌑,🌑,🌑,🌑,🌑,🌑,🌑,🌑,🌑,🌑,🌑,🌑,🌑,🌑,🌑,🌑,🌑,🌑,🌑,🌑,🌑,🌑,🌑,🌑,🌑,🌑,🌑,🌑,🌑,🌑,🌑,🌑,🌑,🌑
|🌑,🌑,🌑,🌑,🌑,🌑,🌑,🌑,🌑,🌑,🌑,🌑,🌑,🌑,🌑,🌑,🌑,🌑,🌑,🌑,🌑,🌑,🌑,🌑,🌑,🌑,🌑,🌑,🌑,🌑,🌑,🌑,🌲,🌑,🌑,🌑,🌑,🌑,🌑,🌑,🌑,🌑,🌑,🌑,🌑,🌑,🌑,🌑,🌑,🌑,🌑,🌑,🌑,🌑,🌑,🌑,🌑,🌑,🌑,🌑,🌑,🌑,🌑
|🌑,🌑,🌑,🌑,🌑,🌑,🌑,🌑,🌑,🌑,🌑,🌑,🌑,🌑,🌑,🌑,🌑,🌑,🌑,🐚,🌑,🌑,🌑,🌑,🌑,🌑,🌑,🌑,🌑,🌑,🌑,🌑,🌑,🌑,🌲,🌑,🌑,🌑,🌑,🌑,🌑,🌑,🌑,🌑,🌑,🌑,🌑,🌑,🌑,🌑,🌑,🌑,🌑,🌑,🌑,🌑,🌑,🌑,🌑,🌑,🌑,🌑,🌑
|🌑,🌑,🌑,🌑,🌑,🌑,🌑,🌑,🌑,🌑,🌑,🌑,🌑,🌑,🌑,✳️,🌑,🌑,🌑,🌑,🌑,🌑,🌑,🌑,🌑,🌑,🌑,🌑,🌑,🌑,🌑,✳️,🌑,🌑,🌑,🌑,🌑,🌑,🌑,🌑,🌲,🌑,🌑,🌑,🌑,🌑,✳️,🌑,🌑,🌑,🌑,🌑,🌑,🌑,🌑,🌑,🌑,🌑,🌑,🌑,🌑,🌑,✳️
|🌑,🌑,🌑,🌑,🌑,🌑,🌑,🌑,🌑,🌑,🌑,🌑,🌑,🌑,🌑,🌑,🌑,🌑,🌑,🌑,🌑,🌑,🌑,🌑,🌑,🌑,🌑,🌑,🌑,🌑,🌑,🌑,🌑,🌑,🌑,🌑,🌑,🌑,🌲,🌑,🌑,🌑,🌲,🌑,🌑,🌑,🌑,🌑,🌑,🌑,🌑,🌑,🌑,🌑,🌑,🌑,🌑,🌑,🌑,🌑,🌑,🌑,🌑
|🌑,🌑,🌑,🌑,🌑,🌑,🌑,🌑,🌑,🌑,🌑,🌑,🌑,🌑,🌑,🌑,🌑,🌑,🌑,🌑,🌑,🌑,🌑,🌑,🌑,🌑,🌑,🌑,🌑,🌑,🌑,🌑,🌑,🌑,🌲,🌑,🌑,🌑,🌑,🌑,🌑,🌑,🌑,🌑,🌑,🌑,🌑,🌑,🌑,🌑,🌑,🌑,🌑,🌑,🌑,🌑,🌑,🌑,🌑,🌑,🌑,🌑,🌑
|🌑,🌑,🌑,✳️,🌑,🌑,🌑,🌑,🌑,🌑,🌑,🌑,🌑,🌑,🌑,🌑,🌑,🌑,🌑,🌑,🌑,🌑,🌑,🌑,🌑,🌑,🌑,🌑,🌑,🌑,🌑,🌑,🌑,🌑,🌑,🌑,🌑,🌑,🌑,🌑,🌑,🌑,🌑,🌑,🌑,🌑,🌑,🌑,🌑,🌑,🌑,🌑,🌑,🌑,🌑,🌑,🌑,🌑,🌑,🌑,🌑,🌑,🌑
|🌑,🌑,🌑,🌑,🌑,🌑,🌑,🌑,🌑,🌑,🌑,🌑,🌑,🌑,🌑,🌑,🌑,🌑,🌑,🌑,🌑,🌑,🌑,🌑,🌑,🌑,🌑,🌑,🌑,🌑,🌑,🌑,🌑,🌑,🌑,🌑,🌲,🌑,🌑,🌑,🌑,🌑,🌑,🌑,🌑,🌑,🌑,🌑,🌑,🌑,🌑,🌑,🌑,🌑,🌑,🌑,🌑,🌑,🌑,🌑,🌑,🌑,🌑
|🌑,🌑,🌑,🌑,🌑,🌑,🌑,🌑,🌑,🌑,🌑,🌑,🌑,🌑,🌑,🌑,🌑,🌑,🌑,🌑,🌑,🌑,🌑,🌑,🌑,🌑,🌑,🌑,🌑,🌑,🌑,🌑,🌑,🌲,🌑,🌑,🌑,🌑,🌑,🌑,🌑,🌑,🌑,🌑,🌑,🌑,🌑,🌑,🌑,🌑,🌑,🌑,🌑,🌑,🌑,🌑,🌑,🌑,🌑,🌑,🌑,🌑,🌑
|🌑,🌑,🌑,🌑,🌑,🌑,🌑,🌑,🌑,🌑,🌑,🌑,🌑,🌑,🌑,🌲,🌑,🌑,🌑,🌑,🌑,🌑,🌑,🌑,🌑,🌑,🌑,🌑,🌑,🌑,🌑,🌑,🌑,🌑,🌑,🌑,🌑,🌑,🌑,🌑,🌑,🌑,🌑,🌑,🌑,🌑,🌑,🌑,🌑,🌑,🌑,🌑,🌑,🌑,🌑,🌑,🌑,🌑,🌑,🌑,🌑,🌑,🌑
|🌑,🌑,🌑,🌑,🌑,🌑,🌑,🌑,🌑,🌑,🌑,🌑,🌑,🌑,🌑,🌑,🌑,🌑,🌑,🌑,🌑,🌑,🌑,🌑,🌑,🌑,🌑,🌑,🌑,🌑,🌑,🌑,🌑,🌑,🌑,🌑,🌑,🌲,🌑,🌑,🌑,🌑,🌑,🌑,🌑,🌑,🌑,🌑,🌑,🌑,🌑,🌑,🌑,🌑,🌑,🌑,🌑,🌑,🌑,🌑,🌑,🌑,🌑
|🌑,🌑,🌑,🌑,🌑,🌑,🌑,🌑,🌑,🌑,🌑,🌑,🌑,🌑,🌑,🌑,🌑,🌑,🌑,🌑,🌑,🌑,🌑,🌑,🌑,🌑,🌑,🌑,🌑,🌑,🌑,🌑,🌲,🌑,🌑,🌲,🌑,🌑,🌑,🌑,🌑,🌑,🌑,🌑,🌑,🌑,🌑,🌑,🌑,🌑,🌑,🌑,🌑,🌑,🌑,🌑,🌑,🌑,🌑,🌑,🌑,🌑,🌑
|🌑,🌑,🌑,🌑,🌑,🌑,🌑,🌑,🌑,🌑,🌑,🌑,🌑,🌑,🌑,🌑,🌑,🌑,🌑,🌑,🌑,🌑,🌑,🌑,🌑,🌑,🌑,🌑,🌑,🌑,🌑,🌑,🌑,🌑,🌑,🌑,🌑,🌑,🌑,🌑,🌑,🌑,🌑,🌑,🌑,🌑,🌑,🌑,🌑,🌑,🌑,🌑,🌑,🌑,🌑,🌑,🌑,🌑,🌑,🌑,🌑,🌑,🌑
|🌑,🌑,🌑,🌑,🌑,🌑,🌑,🌑,🌑,🌑,🌑,🌑,🌑,🌑,🌑,🌑,🌑,🌑,🌑,🌑,🌑,🌑,🌑,🌑,🌑,🌑,🌑,🌑,🌑,🌑,🌑,🌑,🌑,🌑,🌑,🌑,🌑,🌑,🌑,🌑,🌑,🌑,🌑,🌑,🌑,🌑,🌑,🌑,🌑,🌑,🌑,🌑,🌑,🌑,🌑,🌑,🌑,🌑,🌑,🌑,🌑,🌑,🌑
|🌑,🌑,🌑,🌑,🌑,🌑,🌑,🌑,🌑,🌑,🌑,🌑,🌑,🌑,🌑,🌑,🌑,🌑,🌑,🌑,🌑,🌑,🌑,🌑,🌑,🌑,🌑,🌑,🌑,🌑,🌑,🌑,🌑,🌑,🌑,🌑,🌑,🌑,🌑,🌑,🌑,🌑,🌑,🌑,🌑,🌑,🌑,🌑,🌑,🌑,🌑,🌑,🌑,🌑,🌑,🌑,🌑,🌑,🌑,🌑,🌑,🌑,🌑
|🌑,🌑,🌑,✳️,🌑,🌑,🌑,🌑,🌑,🌑,🌑,🌑,🌑,✳️,🌑,🌑,🌑,🌑,🌑,🌑,🌑,🌑,🌑,🌑,🌑,🌑,🌑,🌑,🌲,🌑,🌑,✳️,🌑,🌑,🌑,🌑,🌑,🌑,🌑,🌑,🌑,🌑,🌑,🌑,🌑,🌑,✳️,🌑,🌑,🌑,🌑,🌑,🌑,🌑,🌑,🌑,🌑,🌑,🌑,🌑,🌑,🌑,✳️
|🌑,🌑,🌑,🌑,🌑,🌑,🌑,🌑,🌑,🌑,🌑,🌑,🌑,🌑,🌑,🌑,🌑,🌑,🌑,🌑,🌑,🌑,🌑,🌑,🌑,🌑,🌑,🌑,🌑,🌑,🌑,🌑,🌑,🌑,🌑,🌲,🌑,🌑,🌑,🌑,🌑,🌑,🌑,🌑,🌑,🌑,🌑,🌑,🌑,🌑,🌑,🌑,🌑,🌑,🌑,🌑,🌑,🌑,🌑,🌑,🌑,🌑,🌑
|🌑,🌑,🌑,🌑,🌑,🌑,🌑,🌑,🌑,🌑,🌑,🌑,🌑,🌑,🌑,🌑,🌑,🌑,🌑,🌑,🌑,🌑,🌑,🌑,🌑,🌑,🌑,🌑,🌑,🌑,🌑,🌑,🌑,🌑,🌑,🌑,🌑,🌑,🌑,🌑,🌑,🌑,🌑,🌑,🌑,🌑,🌑,🌑,🌑,🌑,🌑,🌑,🌑,🌑,🌑,🌑,🌑,🌑,🌑,🌑,🌑,🌑,🌑
|🌑,🌑,🌑,🌑,🌑,🌑,🌑,🌑,🌑,🌑,🌑,🌑,🌑,🌑,🌑,🌑,🌑,🌑,🌑,🌑,🌑,🌑,🌑,🌑,🌑,🌑,🌑,🌑,🌑,🌑,🌑,🌑,🌑,🌑,🌑,🌑,🌑,🌑,🌑,🌑,🌑,🌑,🌑,🌑,🌑,🌑,🌑,🌑,🌑,🌑,🌑,🌑,🌑,🌑,🌑,🌑,🌑,🌑,🌑,🌑,🌑,🌑,🌑