|🍃,🌑,🌑,🌑,🌑,🌑,🌑,🌑,🌑,🌑,🌑,🌑,🌑,🌑,🌑,🌑,🌑,🌑,🌑,🌑,🌑,🌑,🌑,🌑,🌑,🌑,🌑,🌑,🌑,🌑,🌑,🌑
|🌑,🌑,🌑,🌑,🌑,🌑,🌑,🌑,🌑,🌑,🌑,🌑,🌑,🌑,🌑,🌑,🌑,🌑,🌑,🌑,🌑,🌑,🌑,🌑,🌑,🌑,🌑,🌑,🌑,🌑,🌑,🌑
|🌑,🌑,🌑,🌑,🌑,🌑,🌑,🌑,🌑,🌑,🌑,🌑,🌑,🌑,🌑,🌑,🌑,🌑,🌑,🌑,🌑,🌑,🌑,🌲,🌑,🌑,🌑,🌑,🌑,🌑,🌑,🌑
|🌑,🌑,🌑,🌑,🌑,🌑,🌑,🌑,🌑,🌑,🌑,🌑,🌑,🌑,🌑,🌑,🌑,🌑,🌑,🌑,🌑,🌑,🌑,🌑,🌑,🌑,🌑,🌑,🌑,🌑,🌑,🌑
|🌑,🌑,🌑,🌑,🌑,🌑,🌑,🌑,🌑,🌑,🌑,🌑,🌑,🌑,🌑,🌑,🌑,🌑,🌑,🌑,🌑,🌑,🌑,🌑,🌑,🌑,🌑,🌑,🌑,🌑,🌑,🌑
|🌑,🌑,🌑,🌑,🌑,🌑,🌑,🌑,🌑,🌑,🌑,🌑,🌑,🌑,🌑,🌑,🌑,🌑,🌑,🌑,🌑,🌑,🌑,🌑,🌑,🌑,🌑,🌑,🌑,🌑,🌑,🌑
|🌑,🌑,🌑,🌑,🌑,🌑,🌑,🌑,🌑,🌑,🌑,🌑,🌑,🌑,🌑,🌑,🌑,🌑,🌑,🌑,🌑,🌑,🌑,🌑,🌑,🌑,🌑,🌑,🌑,🌑,🌑,🌑
|🌑,🌑,🌑,🌑,🌑,🌑,🌑,🌑,🌑,🌑,🌑,🌑,🌑,🌑,🌑,🌑,🌑,🌑,🌑,🌑,🌑,🌑,🌑,🌑,🌑,🌑,🌑,🌑,🌑,🌑,🌑,🌑
|🌑,🌑,🌑,🌑,🌑,🌑,🌑,🌑,🌑,🌑,🌑,🌑,🌑,🌑,🌑,🌑,🌑,🌑,🌑,🌑,🌑,🌑,🌑,🌑,🌑,🌑,🌑,🌑,🌑,🌑,🌑,🌑
|🌑,🌑,🌑,🌑,🌑,🌑,🌑,🌑,🌑,🌑,🌑,🌑,🌑,🌑,🌑,🌑,🌑,🌑,🌑,🌑,🌑,🌑,🌑,🌑,🌑,🌑,🌑,🌑,🌑,🌑,🌑,🌑
|🌑,🌑,🌑,🌑,🌑,🌑,🌑,🌑,🌑,🌑,🌑,🌑,🌑,🌑,🌑,🌑,🌑,🌑,🌑,🌑,🌑,🌑,🌑,🌑,🌑,🌑,🌑,🌑,🌑,🌑,🌑,🌑
|🌑,🌑,🌑,🌑,🌑,🌑,🌑,🌑,🌑,🌑,🌑,🌑,🌑,🌑,🌑,🌑,🌑,🌑,🌑,🌑,🌑,🌑,🌑,🌑,🌑,🌑,🌑,🌑,🌑,🌑,🌑,🌑
|🌑,🌑,🌑,🌑,🌑,🌑,🌑,🌑,🌑,🌑,🌑,🌑,🌑,🌑,🌑,🌑,🌑,🌑,🌑,🌑,🌑,🌑,🌑,🌑,🌑,🌑,🌑,🌑,🌑,🌑,🌑,🌑
|🌑,🌑,🌑,🌑,🌑,🌑,🌑,🌑,🌑,🌑,🌑,🌑,🌑,🌑,🌑,🌑,🌑,🌑,🌑,🌑,🌑,🌑,🌑,🌑,🌑,🌑,🌑,🌑,🌑,🌑,🌑,🌑
|🌑,🌑,🌑,🌑,🌑,🌑,🌑,🌑,🌑,🌑,🌑,🌑,🌑,🌑,🌑,🌑,🌑,🌑,🌑,🌑,🌑,🌑,🌑,🌑,🌑,🌑,🌑,🌑,🌑,🌑,🌑,🌑
|🌑,🌑,🌑,🌑,🌑,🌑,🌑,🌑,🌑,🌑,🌑,🌑,🌑,🌑,🌑,🌑,🌑,🌑,🌑,🌑,🌑,🌑,🌑,🌑,🌑,🌑,🌑,🌑,🌑,🌑,🌑,🌑
|🌑,🌑,🌑,🌑,🌑,🌑,🌑,🌑,🌑,🌑,🌑,🌑,🌑,🌑,🌑,🌑,🌑,🌑,🌑,🌑,🌑,🌑,🌑,🌑,🌑,🌑,🌑,🌑,🌑,🌑,🌑,🌑
|🌑,🌑,🌑,🌑,🌑,🌑,🌑,🌑,🌑,🌑,🌑,🌑,🌑,🌑,🌑,🌑,🌑,🌑,🌑,🌑,🌑,🌑,🌑,🌑,🌑,🌑,🌑,🌑,🌑,🌑,🌑,🌑
|🌑,🌑,🌑,🌑,🌑,🌑,🌑,🌑,🌑,🌑,🌑,🌑,🌑,🌑,🌑,🌑,🌑,🌑,🌑,🌑,🌑,🌑,🌑,🌑,🌑,🌑,🌑,🌑,🌑,🌑,🌑,🌑
|🌑,🌑,🌑,🌑,🌑,🌑,🌑,🌑,🌑,🌑,🌑,🌑,🌑,🌑,🌑,🌑,🌑,🌑,🌑,🌑,🌑,🌑,🌑,🌑,🌑,🌑,🌑,🌑,🌑,🌑,🌑,🌑
|🌑,🌑,🌑,🌑,🌑,🌑,🌑,🌑,🌑,🌑,🌑,🌑,🌑,🌑,🌑,🌑,🌑,🌑,🌑,🌑,🌑,🌑,🌑,🌑,🌑,🌑,🌑,🌑,🌑,🌑,🌑,🌑
|🌑,🌑,🌑,🌑,🌑,🌑,🌑,🌑,🌑,🌑,🌑,🌑,🌑,🌑,🌑,🌑,🌑,🌑,🌑,🌑,🌑,🌑,🌑,🌑,🌑,🌑,🌑,🌑,🌑,🌑,🌑,🌑
|🌑,🌑,🌑,🌑,🌑,🌑,🌑,🌑,🌑,🌑,🌑,🌑,🌑,🌑,🌑,🌑,🌑,🌑,🌑,🌑,🌑,🌑,🌑,🌑,🌑,🌑,🌑,🌑,🌑,🌑,🌑,🌑
|🌑,🌑,🌑,🌑,🌑,🌑,🌑,🌑,🌑,🌑,🌑,🌑,🌑,🌑,🌑,🌑,🌑,🌑,🌑,🌑,🌑,🌑,🌑,🌑,🌑,🌑,🌑,🌑,🌑,🌑,🌑,🌑
|🌑,🌑,🌑,🌑,🌑,🌑,🌑,🌑,🌑,🌑,🌑,🌑,🌑,🌑,🌑,🌑,🌑,🌑,🌑,🌑,🌑,🌑,🌑,🌑,🌑,🌑,🌑,🌑,🌑,🌑,🌑,🌑
|🌑,🌑,🌑,🌑,🌑,🌑,🌑,🌑,🌑,🌑,🌑,🌑,🌑,🌑,🌑,🌑,🌑,🌑,🌑,🌑,🌑,🌑,🌑,🌑,🌑,🌑,🌑,🌑,🌑,🌑,🌑,🌑
|🌑,🌑,🌑,🌑,🌑,🌑,🌑,🌑,🌑,🌑,🌑,🌑,🌑,🌑,🌑,🌑,🌑,🌑,🌑,🌑,🌑,🌑,🌑,🌑,🌑,🌑,🌑,🌑,🌑,🌑,🌑,🌑
|🌑,🌑,🌑,🌑,🌑,🌑,🌑,🌑,🌑,🌑,🌑,🌑,🌑,🌑,🌑,🌑,🌑,🌑,🌑,🌑,🌑,🌑,🌑,🌑,🌑,🌑,🌑,🌑,🌑,🌑,🌑,🌑
|🌑,🌑,🌑,🌑,🌑,🌑,🌑,🌑,🌑,🌑,🌑,🌑,🌑,🌑,🌑,🌑,🌑,🌑,🌑,🌑,🌑,🌑,🌑,🌑,🌑,🌑,🌑,🌑,🌑,🌑,🌑,🌑
|🌑,🌑,🌑,🌑,🌑,🌑,🌑,🌑,🌑,🌑,🌑,🌑,🌑,🌑,🌑,🌑,🌑,🌑,🌑,🌑,🌑,🌑,🌑,🌑,🌑,🌑,🌑,🌑,🌑,🌑,🌑,🌑
|🌑,🌑,🌑,🌑,🌑,↘️,🌑,🌑,🌑,🌑,🌑,🌑,🌑,🌑,🌑,⬇️,🌑,🌑,🌑,🌑,🌑,🌑,🌑,🌑,🌑,🌑,🌑,🌑,⬇️,🌑,🌑,🌑
|🌑,🌑,🌑,🌑,🌑,🌑,🌑,🌑,🌑,🌑,🌑,🌑,🌑,🌑,🌑,🌑,🌑,🌑,🌑,🌑,🌑,🌑,🌑,🌑,🌑,🌑,🌑,🌑,🌑,🌑,🌑,🌑
|🌑,🌑,🌑,🌑,🌑,🌑,🌑,🌑,🌑,🌑,🌑,🌑,🌑,🌑,🌑,🌑,🌑,🌑,🌑,🌑,🌑,🌑,🌑,🌑,🌑,🌑,🌑,🌑,🌑,🌑,🌑,🌑
|🌑,🌑,🌑,🌑,🌑,🌑,🌑,🌑,🌑,🌑,🌑,🌑,🌑,🌑,🌑,🌑,🌑,🌑,🌑,🌑,🌑,🌑,🌑,🌑,🌑,🌑,🌲,🌑,🌑,🌑,🌑,🌑
|🌑,🌑,🌑,🌑,🌑,🌑,🌑,🌑,🌑,🌑,🌑,🌑,🌑,🌑,🌑,🌑,🌑,🌑,🌑,🌑,🌑,🌑,🌑,🌑,🌑,🌑,🌑,🌑,🌑,🌑,🌑,✳️
|🌑,🌑,🌑,🌑,🌑,🌑,🌑,🌑,🌑,🌑,🌑,🌑,🌑,🌑,🌑,✳️,🌑,🌑,🌑,🌑,🌑,🌑,🌑,🌑,🌑,🌑,🌑,🌑,🌑,🌑,🌑,🌑
|🌲,🌑,🌑,🌑,🌑,🌑,🌑,🌑,🌑,🌑,🌑,🌑,🌑,🌑,🌑,🌑,🌑,🌑,🌑,🌑,🌑,🌑,🌑,🌑,🌑,🌑,🌑,🌑,🌑,🌑,🌑,🌑
|🌑,🌑,🌑,🌑,🌑,🌑,🌑,🌑,🌑,🌑,🌑,🌑,🌑,🌑,🌑,🌑,🌑,🌑,🌑,🌑,🌑,🌑,🌑,🌑,🌑,🌑,🌑,🌑,🌑,🌑,🌑,🌑
|🌑,🌑,🌑,🌑,🌑,🌑,🌑,🌑,🌑,🌑,🌑,🌑,🌑,🌑,🌑,🌑,🌑,🌑,🌑,🌑,🌑,🌑,🌑,🌑,🌑,🌑,🌑,🌑,🌑,🌑,🌑,🌑
|🌑,🌑,🌑,🌑,✳️,🌑,🌑,🌑,🌑,🌑,🌑,🌑,🌑,🌑,🌑,🌑,🌲,🌑,🌑,🌑,🌑,🌑,🌑,🌑,🌑,🌑,🌑,🌑,🌑,🌑,🌑,🌑
|🌑,🌑,🌑,🌑,🌑,🌑,🌑,🌑,🌑,🌑,🌑,🌑,🌑,🌑,🌑,🌑,🌑,🌑,🌑,🌑,🌑,🌑,🌑,🌑,🌑,🌑,🌑,🌑,🌑,🌑,🌑,🌑
|🌑,🌑,🌑,🌑,🌑,🌑,🌑,🌑,🌑,🌑,🌑,🌑,🌑,🌑,🌑,🌑,🌑,🌑,🌑,🌑,🌑,🌑,🌑,🌑,🌑,🌑,🌑,🌑,🌑,🌑,🌑,🌑
|🌑,🌑,🌑,🌑,🌑,🌑,🌑,🌑,🌑,🌑,🌑,🌑,🌑,🌑,🌑,🌑,🌑,🌑,🌑,🌑,🌑,🌑,🌑,🌑,🌑,🌑,🌑,🌑,🌑,🌑,🌑,🌑
|🌑,🌑,🌑,🌑,🌑,🌑,🌑,🌑,🌑,🌑,🌑,🌑,🌑,🌑,🌑,🌑,🌑,🌑,🌑,🌑,🌑,🌑,🌑,🌑,🌑,🌑,🌑,🌑,🌑,🌑,🌑,🌑
|🌑,🌑,🌑,🌑,🌑,🌑,🌑,🌑,🌑,🌑,🌑,🌑,🌑,🌑,🌑,🌑,🌑,🌑,🌑,🌑,🌑,🌑,🌑,🌑,🌑,🌑,🌑,🌑,🌑,🌑,🌑,🌑
|🌑,🌑,🌑,🌑,🌑,🌑,🌑,🌑,🌑,🌑,🌑,🌑,🌑,🌑,🌑,🌑,🌑,🌑,🌑,🌑,🌑,🌑,🌑,🌑,🌑,🌑,🌑,🌑,🌑,🌑,🌑,🌑
|🌑,🌑,🌑,🌑,🌑,🌑,🌑,🌑,🌑,🌑,🌑,🌑,🌑,🌑,🌑,✳️,🌑,🌑,🌑,🌑,🌑,🌑,🌑,🌑,🌑,🌑,🌑,🌑,🌑,🌑,🌑,✳️
|🌑,🌑,🌑,🌑,🌑,🌑,🌑,🌑,🌑,🌑,🌑,🌑,🌑,🌑,🌑,🌑,🌑,🌑,🌑,🌑,🌑,🌑,🌑,🌑,🌑,🌑,🌑,🌑,🌑,🌑,🌑,🌑
|🌑,🌑,🌑,🌑,🌑,🌑,🌑,🌑,🌑,🌑,🌑,🌑,🌑,🌑,🌑,🌑,🌑,🌑,🌑,🌑,🌑,🌑,🌑,🌑,🌑,🌑,🌑,🌑,🌑,🌑,🌑,🌑
|🌑,🌑,🌑,✳️,🌑,🌑,🌑,🌑,🌑,🌑,🌑,🌑,🌑,🌑,🌑,🌑,🌑,🌑,🌑,🌑,🌑,🌑,🌑,🌑,🌑,🌑,🌑,🌑,🌑,🌑,🌑,🌑
|🌑,🌑,🌑,🌑,🌑,🌑,🌑,🌑,🌑,🌑,🌑,🌑,🌑,🌑,🌑,🌑,🌑,🌑,🌑,🌑,🌑,🌑,🌑,🌑,🌑,🌑,🌑,🌑,🌑,🌑,🌑,🌑
|🌑,🌑,🌑,🌑,🌑,🌑,🌑,🌑,🌑,🌑,🌑,🌑,🌑,🌑,🌑,🌑,🌑,🌑,🌑,🌑,🌑,🌑,🌑,🌑,🌑,🌑,🌑,🌑,🌑,🌑,🌑,🌑
|🌑,🌑,🌑,🌑,🌑,🌑,🌑,🌑,🌑,🌑,🌑,🌑,🌑,🌑,🌑,🌑,🌑,🌑,🌑,🌑,🌑,🌑,🌑,🌑,🌑,🌑,🌑,🌲,🌑,🌑,🌑,🌑
|🌑,🌑,🌑,🌑,🌑,🌑,🌑,🌑,🌑,🌑,🌑,🌑,🌑,🌑,🌑,🌑,🌑,🌑,🌑,🌑,🌑,🌑,🌑,🌑,🌑,🌑,🌑,🌑,🌑,🌑,🌑,🌑
|🌑,🌑,🌑,🌑,🌑,🌑,🌑,🌑,🌑,🌑,🌑,🌑,🌑,🌑,🌑,🌑,🌑,🌑,🌑,🌑,🌑,🌑,🌑,🌑,🌑,🌑,🌑,🌑,🌑,🌑,🌑,🌑
|🌑,🌑,🌑,🌑,🌑,🌑,🌑,🌑,🌑,🌑,🌑,🌑,🌑,🌑,🌑,🌑,🌑,🌑,🌑,🌑,🌑,🌑,🌑,🌑,🌑,🌑,🌑,🌑,🌑,🌑,🌑,🌑
|🌑,🌑,🌑,🌑,🌑,🌑,🌑,🌑,🌑,🌑,🌑,🌑,🌑,🌑,🌑,🌑,🌑,🌑,🌑,🌑,🌑,🌑,🌑,🌑,🌑,🌑,🌑,🌑,🌑,🌑,🌑,🌑
|🌑,🌑,🌑,🌑,🌑,🌑,🌑,🌑,🌑,🌑,🌑,🌑,🌑,🌑,🌑,🌑,🌑,🌑,🌑,🌑,🌑,🌑,🌑,🌑,🌑,🌑,🌑,🌑,🌑,🌑,🌑,🌑
|🌑,🌑,🌑,✳️,🌑,🌑,🌑,🌑,🌑,🌑,🌑,🌑,🌑,✳️,🌑,🌑,🌑,🌑,🌑,🌑,🌑,🌑,🌑,🌑,🌑,🌑,🌑,🌑,🌑,🌑,🌑,✳️
|🌑,🌑,🌑,🌑,🌑,🌑,🌑,🌑,🌑,🌑,🌑,🌑,🌑,🌑,🌑,🌑,🌑,🌑,🌑,🌑,🌑,🌑,🌑,🌑,🌑,🌑,🌑,🌑,🌑,🌑,🌑,🌑
|🌑,🌑,🌑,🌑,🌑,🌑,🌑,🌑,🌑,🌑,🌑,🌑,🌑,🌑,🌑,🌑,🌑,🌑,🌑,🌑,🌑,🌑,🌑,🌑,🌑,🌑,🌑,🌑,🌑,🌑,🌑,🌑
|🌑,🌑,🌑,🌑,🌑,🌑,🌑,🌑,🌑,🌑,🌑,🌑,🌑,🌑,🌑,🌑,🌑,🌑,🌑,🌑,🌑,🌑,🌑,🌑,🌑,🌑,🌑,🌑,🌑,🌑,🌑,🌑