|🌵,🌑,🌑,🌑,🌑,🌑,🌑,🌑,🌑,🌑,🌑,🌑,🌑,🌑,🌑,🌑,🌑,🌑,🌑,🌑,🏜,🌑,🌑,🌑,🌑,🌑,🌑,🌑,🌑,🌑,🌑,🌑,🌑,🌑,🌑,🌑,🌑,🌑,🌑,🌑,🗾,🌑,🌑,🌑,🌑,🌑,🌑
|🌑,🌑,🌑,🌑,🌑,🌑,🌑,🌑,🌑,🌑,🌑,🌑,🌑,🌑,🌑,🌑,🌑,🌑,🌑,🌑,🌑,🌑,🌑,🌑,🌑,🌑,🌑,🌑,🌑,🌑,🌑,🌑,🌑,🌑,🌑,🌑,🌑,🌑,🌑,🌑,🌑,🌑,🌑,🌑,🌑,🌑,🌑
|🌑,🌑,🌑,🌑,🌑,🌑,🌑,🌑,🌑,🌑,🌑,🌑,🌑,🌑,🌑,🌑,🌑,🌑,🌑,🌑,🌑,🌑,🌑,🌑,🌑,🌑,🌑,🌑,🌑,🌑,🌑,🌑,🌑,🌑,🌑,🌑,🌑,🌑,🌑,🌑,🌑,🌑,🌑,🌑,🌑,🌑,🌑
|🌑,🌑,🌑,🌑,🌑,🌑,🌑,🌑,🌑,🌑,🌑,🌑,🌑,🌑,🌑,🌑,🌑,🌑,🌑,🌑,🌑,🌑,🌑,🌑,🌑,🌑,🌑,🌑,🌑,🌑,🌑,🌑,🌑,🌑,🌑,🌑,🌑,🌑,🌑,🌑,🌑,🌑,🌑,🌑,🌑,🌑,🌑
|🌑,🌑,🌑,🌑,🌑,🌑,🌑,🌑,🌑,🌑,🌑,🌑,🌑,🌑,🌑,🌑,🌑,🌑,🌑,🌑,🌑,🌑,🌑,🌑,🌑,🌑,🌑,🌑,🌑,🌑,🌑,🌑,🌑,🌑,🌑,🌑,🌑,🌑,🌑,🌑,🌑,🌑,🌑,🌑,🌑,🌑,🌑
|🌑,🌑,🌑,🌑,🌑,🌑,🌑,🌑,🌑,🌑,🌑,🌑,🌑,🌑,🌑,🌑,🌑,🌑,🌑,🌑,🌑,🌑,🌑,🌑,🌑,🌑,🌑,🌑,🌑,🌑,🌑,🌑,🌑,🌑,🌑,🌑,🌑,🌑,🌑,🌑,🌑,🌑,🌑,🌑,🌑,🌑,🌑
|🌑,🌑,🌑,🌑,🌑,🌑,🌑,🌑,🌑,🌑,🌑,🌑,🌑,🌑,🌑,🌑,🌑,🌑,🌑,🌑,🌑,🌑,🌑,🌑,🌑,🌑,🌑,🌑,🌑,🌑,🌑,🌑,🌑,🌑,🌑,🌑,🌑,🌑,🌑,🌑,🌑,🌑,🌑,🌑,🌑,🌑,🌑
|🌑,🌑,🌑,🌑,🌑,🌑,🌑,🌑,🌑,🌑,🌑,🌑,🌑,🌑,🌑,🌑,🌑,🌑,🌑,🌑,🌑,🌑,🌑,🌑,🌑,🌑,🌑,🌑,🌑,🌑,🌑,🌑,🌑,🌑,🌑,🌑,🌑,🌑,🌑,🌑,🌑,🌑,🌑,🌑,🌑,🌑,🌑
|🌑,🌑,🌑,🌑,🌑,🌑,🌑,🌑,🌑,🌑,🌑,🌑,🌑,🌑,🌑,🌑,🌑,🌑,🌑,🌑,🌑,🌑,🌑,🌑,🌑,🌑,🌑,🌑,🌑,🌑,🌑,🌑,🌑,🌑,🌑,🌑,🌑,🌑,🌑,🌑,🌑,🌑,🌑,🌑,🌑,🌑,🌑
|🌑,🌑,🌑,🌑,🌑,🌑,🌑,🌑,🌑,🌑,🌑,🌑,🌑,🌑,🌑,🌑,🌑,🌑,🌑,🌑,🌑,🌑,🌑,🌑,🌑,🌑,🌑,🌑,🌑,🌑,🌑,🌑,🌑,🌑,🌑,🌑,🌑,🌑,🌑,🌑,🌑,🌑,🌑,🌑,🌑,🌑,🌑
|🌑,🌑,🌑,🌑,🌑,🌑,🌑,🌑,🌑,🌑,🌑,🌑,🌑,🌑,🌑,🌑,🌑,🌑,🌑,🌑,🌑,🌑,🌑,🌑,🌑,🌑,🌑,🌑,🌑,🌑,🌑,🌑,🌑,🌑,🌑,🌑,🌑,🌑,🌑,🌑,🌑,🌑,🌑,🌑,🌑,🌑,🌑
|🌑,🌑,🌑,🌑,🌑,🌑,🌑,🌑,🌑,🌑,🌑,🌑,🌑,🌑,🌑,🌑,🌑,🌑,🌑,🌑,🌑,🌑,🌑,🌑,🌑,🌑,🌑,🌑,🌑,🌑,🌑,🌑,🌑,🌑,🌑,🌑,🌑,🌑,🌑,🌑,🌑,🌑,🌑,🌑,🌑,🌑,🌑
|🌑,🌑,🌑,🌑,🌑,🌑,🌑,🌑,🌑,🌑,🌑,🌑,🌑,🌑,🌑,🌑,🌑,🌑,🌑,🌑,🌑,🌑,🌑,🌑,🌑,🌑,🌑,🌑,🌑,🌑,🌑,🌑,🌑,🌑,🌑,🌑,🌑,🌑,🌑,🌑,🌑,🌑,🌑,🌑,🌑,🌑,🌑
|🌑,🌑,🌑,🌑,🌑,🌑,🌑,🌑,🌑,🌑,🌑,🌑,🌑,🌑,🌑,🌑,🌑,🌑,🌑,🌑,🌑,🌑,🌑,🌑,🌑,🌑,🌑,🌑,🌑,🌑,🌑,🌑,🌑,🌑,🌑,🌑,🌑,🌑,🌑,🌑,🌑,🌑,🌑,🌑,🌑,🌑,🌑
|🌑,🌑,🌑,🌑,🌑,🌑,🌑,🌑,🌑,🌑,🌑,🌑,🌑,🌑,🌑,🌑,🌑,🌑,🌑,🌑,🌑,🌑,🌑,🌑,🌑,🌑,🌑,🌑,🌑,🌑,🌑,🌑,🌑,🌑,🌑,🌑,🌑,🌑,🌑,🌑,🌑,🌑,🌑,🌑,🌑,🌑,🌑
|🌑,🌑,🌑,🌑,🌑,🌑,🌑,🌑,🌑,🌑,🌑,🌑,🌑,🌑,🌑,🌑,🌑,🌑,🌑,🌑,🌑,🌑,🌑,🌑,🌑,🌑,🌑,🌑,🌑,🌑,🌑,🌑,🌑,🌑,🌑,🌑,🌑,🌑,🌑,🌑,🌑,🌑,🌑,🌑,🌑,🌑,🌑
|🌑,🌑,🌑,🌑,🌑,🌑,🌑,🌑,🌑,🌑,🌑,🌑,🌑,🌑,🌑,🌑,🌑,🌑,🌑,🌑,🌑,🌑,🌑,🌑,🌑,🌑,🌑,🌑,🌑,🌑,🌑,🌑,🌑,🌑,🌑,🌑,🌑,🌑,🌑,🌑,🌑,🌑,🌑,🌑,🌑,🌑,🌑
|🌑,🌑,🌑,🌑,🌑,🌑,🌑,🌑,🌑,🌑,🌑,🌑,🌑,🌑,🌑,🌑,🌑,🌑,🌑,🌑,🌑,🌑,🌑,🌑,🌑,🌑,🌑,🌑,🌑,🌑,🌑,🌑,🌑,🌑,🌑,🌑,🌑,🌑,🌑,🌑,🌑,🌑,🌑,🌑,🌑,🌑,🌑
|🌑,🌑,🌑,🌑,🌑,🌑,🌑,🌑,🌑,🌑,🌑,🌑,🌑,🌑,🌑,🌑,🌑,🌑,🌑,🌑,🌑,🌑,🌑,🌑,🌑,🌑,🌑,🌑,🌑,🌑,🌑,🌑,🌑,🌑,🌑,🌑,🌑,🌑,🌑,🌑,🌑,🌑,🌑,🌑,🌑,🌑,🌑
|🌑,🌑,🌑,🌑,🌑,🌑,🌑,🌑,🌑,🌑,🌑,🌑,🌑,🌑,🌑,🌑,🌑,🌑,🌑,🌑,🌑,🌑,🌑,🌑,🌑,🌑,🌑,🌑,🌑,🌑,🌑,🌑,🌑,🌑,🌑,🌑,🌑,🌑,🌑,🌑,🌑,🌑,🌑,🌑,🌑,🌑,🌑
|🏕,🌑,🌑,🌑,🌑,🌑,🌑,🌑,🌑,🌑,🌑,🌑,🌑,🌑,🌑,🌑,🌑,🌑,🌑,🌑,🏕,🌑,🌑,🌑,🌑,🌑,🌑,🌑,🌑,🌑,🌑,🌑,🌑,🌑,🌑,🌑,🌑,🌑,🌑,🌑,🌵,🌑,🌑,🌑,🌑,🌑,🌑
|🌑,🌑,🌑,🌑,🌑,🌑,🌑,🌑,🌑,🌑,🌑,🌑,🌑,🌑,🌑,🌑,🌑,🌑,🌑,🌑,🌑,🌑,🌑,🌑,🌑,🌑,🌑,🌑,🌑,🌑,🌑,🌑,🌑,🌑,🌑,🌑,🌑,🌑,🌑,🌑,🌑,🌑,🌑,🌑,🌑,🌑,🌑
|🌑,🌑,🌑,🌑,🌑,🌑,🌑,🌑,🌑,🌑,🌑,🌑,🌑,🌑,🌑,🌑,🌑,🌑,🌑,🌑,🌑,🌑,🌑,🌑,🌑,🌑,🌑,🌑,🌑,🌑,🌑,🌑,🌑,🌑,🌑,🌑,🌑,🌑,🌑,🌑,🌑,🌑,🌑,🌑,🌑,🌑,🌑
|🌑,🌑,🌑,🌑,🌑,🌑,🌑,🌑,🌑,🌑,🌑,🌑,🌑,🌑,🌑,🌑,🌑,🌑,🌑,🌑,🌑,🌑,🌑,🌑,🌑,🌑,🌑,🌑,🌑,🌑,🌑,🌑,🌑,🌑,🌑,🌑,🌑,🌑,🌑,🌑,🌑,🌑,🌑,🌑,🌑,🌑,🌑
|🌑,🌑,🌑,🌑,🌑,🌑,🌑,🌑,🌑,🌑,🌑,🌑,🌑,🌑,🌑,🌑,🌑,🌑,🌑,🌑,🌑,🌑,🌑,🌑,🌑,🌑,🌑,🌑,🌑,🌑,🌑,🌑,🌑,🌑,🌑,🌑,🌑,🌑,🌑,🌑,🌑,🌑,🌑,🌑,🌑,🌑,🌑
|🌑,🌑,🌑,🌑,🌑,🌑,🌑,🌑,🌑,🌑,🌑,🌑,🌑,🌑,🌑,🌑,🌑,🌑,🌑,🌑,🌑,🌑,🌑,🌑,🌑,🌑,🌑,🌑,🌑,🌑,🌑,🌑,🌑,🌑,🌑,🌑,🌑,🌑,🌑,🌑,🌑,🌑,🌑,🌑,🌑,🌑,🌑
|🌑,🌑,🌑,🌑,🌑,🌑,🌑,🌑,🌑,🌑,🌑,🌑,🌑,🌑,🌑,🌑,🌑,🌑,🌑,🌑,🌑,🌑,🌑,🌑,🌑,🌑,🌑,🌑,🌑,🌑,🌑,🌑,🌑,🌑,🌑,🌑,🌑,🌑,🌑,🌑,🌑,🌑,🌑,🌑,🌑,🌑,🌑
|🌑,🌑,🌑,🌑,🌑,🌑,🌑,🌑,🌑,🌑,🌑,🌑,🌑,🌑,🌑,🌑,🌑,🌑,🌑,🌑,🌑,🌑,🌑,🌑,🌑,🌑,🌑,🌑,🌑,🌑,🌑,🌑,🌑,🌑,🌑,🌑,🌑,🌑,🌑,🌑,🌑,🌑,🌑,🌑,🌑,🌑,🌑
|🌑,🌑,🌑,🌑,🌑,🌑,🌑,🌑,🌑,🌑,🌑,🌑,🌑,🌑,🌑,🌑,🌑,🌑,🌑,🌑,🌑,🌑,🌑,🌑,🌑,🌑,🌑,🌑,🌑,🌑,🌑,🌑,🌑,🌑,🌑,🌑,🌑,🌑,🌑,🌑,🌑,🌑,🌑,🌑,🌑,🌑,🌑
|🌑,🌑,🌑,🌑,🌑,🌑,🌑,🌑,🌑,🌑,🌑,🌑,🌑,🌑,🌑,🌑,🌑,🌑,🌑,🌑,🌑,🌑,🌑,🌑,🌑,🌑,🌑,🌑,🌑,🌑,🌑,🌑,🌑,🌑,🌑,🌑,🌑,🌑,🌑,🌑,🌑,🌑,🌑,🌑,🌑,🌑,🌑
|🌑,🌑,🌑,🌑,🌑,🌑,🌑,🌑,🌑,🌑,🌑,🌑,🌑,🌑,🌑,🌑,🌑,🌑,🌑,🌑,🌑,🌑,🌑,🌑,🌑,🌑,🌑,🌑,🌑,🌑,🌑,🌑,🌑,🌑,🌑,🌑,🌑,🌑,🌑,🌑,🌑,🌑,🌑,🌑,🌑,🌑,🌑
|🌑,🌑,🌑,🌑,🌑,🌑,🌑,🌑,🌑,🌑,🌑,🌑,🌑,🌑,🌑,🌑,🌑,🌑,🌑,🌑,🌑,🌑,🌑,🌑,🌑,🌑,🌑,🌑,🌑,🌑,🌑,🌑,🌑,🌑,🌑,🌑,🌑,🌑,🌑,🌑,🌑,🌑,🌑,🌑,🌑,🌑,🌑
|🌑,🌑,🌑,🌑,🌑,🌑,🌑,🌑,🌑,🌑,🌑,🌑,🌑,🌑,🌑,🌑,🌑,🌑,🌑,🌑,🌑,🌑,🌑,🌑,🌑,🌑,🌑,🌑,🌑,🌑,🌑,🌑,🌑,🌑,🌑,🌑,🌑,🌑,🌑,🌑,🌑,🌑,🌑,🌑,🌑,🌑,🌑
|🌑,🌑,🌑,🌑,🌑,🌑,🌑,🌑,🌑,🌑,🌑,🌑,🌑,🌑,🌑,🌑,🌑,🌑,🌑,🌑,🌑,🌑,🌑,🌑,🌑,🌑,🌑,🌑,🌑,🌑,🌑,🌑,🌑,🌑,🌑,🌑,🌑,🌑,🌑,🌑,🌑,🌑,🌑,🌑,🌑,🌑,🌑
|🌑,🌑,🌑,🌑,🌑,🌑,🌑,🌑,🌑,🌑,🌑,🌑,🌑,🌑,🌑,🌑,🌑,🌑,🌑,🌑,🌑,🌑,🌑,🌑,🌑,🌑,🌑,🌑,🌑,🌑,🌑,🌑,🌑,🌑,🌑,🌑,🌑,🌑,🌑,🌑,🌑,🌑,🌑,🌑,🌑,🌑,🌑
|🌑,🌑,🌑,🌑,🌑,🌑,🌑,🌑,🌑,🌑,🌑,🌑,🌑,🌑,🌑,🌑,🌑,🌑,🌑,🌑,🌑,🌑,🌑,🌑,🌑,🌑,🌑,🌑,🌑,🌑,🌑,🌑,🌑,🌑,🌑,🌑,🌑,🌑,🌑,🌑,🌑,🌑,🌑,🌑,🌑,🌑,🌑
|🌑,🌑,🌑,🌑,🌑,🌑,🌑,🌑,🌑,🌑,🌑,🌑,🌑,🌑,🌑,🌑,🌑,🌑,🌑,🌑,🌑,🌑,🌑,🌑,🌑,🌑,🌑,🌑,🌑,🌑,🌑,🌑,🌑,🌑,🌑,🌑,🌑,🌑,🌑,🌑,🌑,🌑,🌑,🌑,🌑,🌑,🌑
|🌑,🌑,🌑,🌑,🌑,🌑,🌑,🌑,🌑,🌑,🌑,🌑,🌑,🌑,🌑,🌑,🌑,🌑,🌑,🌑,🌑,🌑,🌑,🌑,🌑,🌑,🌑,🌑,🌑,🌑,🌑,🌑,🌑,🌑,🌑,🌑,🌑,🌑,🌑,🌑,🌑,🌑,🌑,🌑,🌑,🌑,🌑
|🌑,🌑,🌑,🌑,🌑,🌑,🌑,🌑,🌑,🌑,🌑,🌑,🌑,🌑,🌑,🌑,🌑,🌑,🌑,🌑,🌑,🌑,🌑,🌑,🌑,🌑,🌑,🌑,🌑,🌑,🌑,🌑,🌑,🌑,🌑,🌑,🌑,🌑,🌑,🌑,🌑,🌑,🌑,🌑,🌑,🌑,🌑
|🌑,🌑,🌑,🌑,🌑,🌑,🌑,🌑,🌑,🌑,🌑,🌑,🌑,🌑,🌑,🌑,🌑,🌑,🌑,🌑,🌑,🌑,🌑,🌑,🌑,🌑,🌑,🌑,🌑,🌑,🌑,🌑,🌑,🌑,🌑,🌑,🌑,🌑,🌑,🌑,🌑,🌑,🌑,🌑,🌑,🌑,🌑
|🌵,🌑,🌑,🌑,🌑,🌑,🌑,🌑,🌑,🌑,🌑,🌑,🌑,🌑,🌑,🌑,🌑,🌑,🌑,🌑,🏕,🌑,🌑,🌑,🌑,🌑,🌑,🌑,🌑,🌑,🌑,🌑,🌑,🌑,🌑,🌑,🌑,🌑,🌑,🌑,🏜,🌑,🌑,🌑,🌑,🌑,🌑
|🌑,🌑,🌑,🌑,🌑,🌑,🌑,🌑,🌑,🌑,🌑,🌑,🌑,🌑,🌑,🌑,🌑,🌑,🌑,🌑,🌑,🌑,🌑,🌑,🌑,🌑,🌑,🌑,🌑,🌑,🌑,🌑,🌑,🌑,🌑,🌑,🌑,🌑,🌑,🌑,🌑,🌑,🌑,🌑,🌑,🌑,🌑
|🌑,🌑,🌑,🌑,🌑,🌑,🌑,🌑,🌑,🌑,🌑,🌑,🌑,🌑,🌑,🌑,🌑,🌑,🌑,🌑,🌑,🌑,🌑,🌑,🌑,🌑,🌑,🌑,🌑,🌑,🌑,🌑,🌑,🌑,🌑,🌑,🌑,🌑,🌑,🌑,🌑,🌑,🌑,🌑,🌑,🌑,🌑
|🌑,🌑,🌑,🌑,🌑,🌑,🌑,🌑,🌑,🌑,🌑,🌑,🌑,🌑,🌑,🌑,🌑,🌑,🌑,🌑,🌑,🌑,🌑,🌑,🌑,🌑,🌑,🌑,🌑,🌑,🌑,🌑,🌑,🌑,🌑,🌑,🌑,🌑,🌑,🌑,🌑,🌑,🌑,🌑,🌑,🌑,🌑
|🌑,🌑,🌑,🌑,🌑,🌑,🌑,🌑,🌑,🌑,🌑,🌑,🌑,🌑,🌑,🌑,🌑,🌑,🌑,🌑,🌑,🌑,🌑,🌑,🌑,🌑,🌑,🌑,🌑,🌑,🌑,🌑,🌑,🌑,🌑,🌑,🌑,🌑,🌑,🌑,🌑,🌑,🌑,🌑,🌑,🌑,🌑
|🌑,🌑,🌑,🌑,🌑,🌑,🌑,🌑,🌑,🌑,🌑,🌑,🌑,🌑,🌑,🌑,🌑,🌑,🌑,🌑,🌑,🌑,🌑,🌑,🌑,🌑,🌑,🌑,🌑,🌑,🌑,🌑,🌑,🌑,🌑,🌑,🌑,🌑,🌑,🌑,🌑,🌑,🌑,🌑,🌑,🌑,🌑
|🌑,🌑,🌑,🌑,🌑,🌑,🌑,🌑,🌑,🌑,🌑,🌑,🌑,🌑,🌑,🌑,🌑,🌑,🌑,🌑,🌑,🌑,🌑,🌑,🌑,🌑,🌑,🌑,🌑,🌑,🌑,🌑,🌑,🌑,🌑,🌑,🌑,🌑,🌑,🌑,🌑,🌑,🌑,🌑,🌑,🌑,🌑
|🌑,🌑,🌑,🌑,🌑,🌑,🌑,🌑,🌑,🌑,🌑,🌑,🌑,🌑,🌑,🌑,🌑,🌑,🌑,🌑,🌑,🌑,🌑,🌑,🌑,🌑,🌑,🌑,🌑,🌑,🌑,🌑,🌑,🌑,🌑,🌑,🌑,🌑,🌑,🌑,🌑,🌑,🌑,🌑,🌑,🌑,🌑
|🌑,🌑,🌑,🌑,🌑,🌑,🌑,🌑,🌑,🌑,🌑,🌑,🌑,🌑,🌑,🌑,🌑,🌑,🌑,🌑,🌑,🌑,🌑,🌑,🌑,🌑,🌑,🌑,🌑,🌑,🌑,🌑,🌑,🌑,🌑,🌑,🌑,🌑,🌑,🌑,🌑,🌑,🌑,🌑,🌑,🌑,🌑
|🌑,🌑,🌑,🌑,🌑,🌑,🌑,🌑,🌑,🌑,🌑,🌑,🌑,🌑,🌑,🌑,🌑,🌑,🌑,🌑,🌑,🌑,🌑,🌑,🌑,🌑,🌑,🌑,🌑,🌑,🌑,🌑,🌑,🌑,🌑,🌑,🌑,🌑,🌑,🌑,🌑,🌑,🌑,🌑,🌑,🌑,🌑
|🌑,🌑,🌑,🌑,🌑,🌑,🌑,🌑,🌑,🌑,🌑,🌑,🌑,🌑,🌑,🌑,🌑,🌑,🌑,🌑,🌑,🌑,🌑,🌑,🌑,🌑,🌑,🌑,🌑,🌑,🌑,🌑,🌑,🌑,🌑,🌑,🌑,🌑,🌑,🌑,🌑,🌑,🌑,🌑,🌑,🌑,🌑
|🌑,🌑,🌑,🌑,🌑,🌑,🌑,🌑,🌑,🌑,🌑,🌑,🌑,🌑,🌑,🌑,🌑,🌑,🌑,🌑,🌑,🌑,🌑,🌑,🌑,🌑,🌑,🌑,🌑,🌑,🌑,🌑,🌑,🌑,🌑,🌑,🌑,🌑,🌑,🌑,🌑,🌑,🌑,🌑,🌑,🌑,🌑
|🌑,🌑,🌑,🌑,🌑,🌑,🌑,🌑,🌑,🌑,🌑,🌑,🌑,🌑,🌑,🌑,🌑,🌑,🌑,🌑,🌑,🌑,🌑,🌑,🌑,🌑,🌑,🌑,🌑,🌑,🌑,🌑,🌑,🌑,🌑,🌑,🌑,🌑,🌑,🌑,🌑,🌑,🌑,🌑,🌑,🌑,🌑
|🌑,🌑,🌑,🌑,🌑,🌑,🌑,🌑,🌑,🌑,🌑,🌑,🌑,🌑,🌑,🌑,🌑,🌑,🌑,🌑,🌑,🌑,🌑,🌑,🌑,🌑,🌑,🌑,🌑,🌑,🌑,🌑,🌑,🌑,🌑,🌑,🌑,🌑,🌑,🌑,🌑,🌑,🌑,🌑,🌑,🌑,🌑
|🌑,🌑,🌑,🌑,🌑,🌑,🌑,🌑,🌑,🌑,🌑,🌑,🌑,🌑,🌑,🌑,🌑,🌑,🌑,🌑,🌑,🌑,🌑,🌑,🌑,🌑,🌑,🌑,🌑,🌑,🌑,🌑,🌑,🌑,🌑,🌑,🌑,🌑,🌑,🌑,🌑,🌑,🌑,🌑,🌑,🌑,🌑
|🌑,🌑,🌑,🌑,🌑,🌑,🌑,🌑,🌑,🌑,🌑,🌑,🌑,🌑,🌑,🌑,🌑,🌑,🌑,🌑,🌑,🌑,🌑,🌑,🌑,🌑,🌑,🌑,🌑,🌑,🌑,🌑,🌑,🌑,🌑,🌑,🌑,🌑,🌑,🌑,🌑,🌑,🌑,🌑,🌑,🌑,🌑
|🌑,🌑,🌑,🌑,🌑,🌑,🌑,🌑,🌑,🌑,🌑,🌑,🌑,🌑,🌑,🌑,🌑,🌑,🌑,🌑,🌑,🌑,🌑,🌑,🌑,🌑,🌑,🌑,🌑,🌑,🌑,🌑,🌑,🌑,🌑,🌑,🌑,🌑,🌑,🌑,🌑,🌑,🌑,🌑,🌑,🌑,🌑
|🌑,🌑,🌑,🌑,🌑,🌑,🌑,🌑,🌑,🌑,🌑,🌑,🌑,🌑,🌑,🌑,🌑,🌑,🌑,🌑,🌑,🌑,🌑,🌑,🌑,🌑,🌑,🌑,🌑,🌑,🌑,🌑,🌑,🌑,🌑,🌑,🌑,🌑,🌑,🌑,🌑,🌑,🌑,🌑,🌑,🌑,🌑
|🌑,🌑,🌑,🌑,🌑,🌑,🌑,🌑,🌑,🌑,🌑,🌑,🌑,🌑,🌑,🌑,🌑,🌑,🌑,🌑,🌑,🌑,🌑,🌑,🌑,🌑,🌑,🌑,🌑,🌑,🌑,🌑,🌑,🌑,🌑,🌑,🌑,🌑,🌑,🌑,🌑,🌑,🌑,🌑,🌑,🌑,🌑
|🌑,🌑,🌑,🌑,🌑,🌑,🌑,🌑,🌑,🌑,🌑,🌑,🌑,🌑,🌑,🌑,🌑,🌑,🌑,🌑,🌑,🌑,🌑,🌑,🌑,🌑,🌑,🌑,🌑,🌑,🌑,🌑,🌑,🌑,🌑,🌑,🌑,🌑,🌑,🌑,🌑,🌑,🌑,🌑,🌑,🌑,🌑
|🌵,🌑,🌑,🌑,🌑,🌑,🌑,🌑,🌑,🌑,🌑,🌑,🌑,🌑,🌑,🌑,🌑,🌑,🌑,🌑,🏕,🌑,🌑,🌑,🌑,🌑,🌑,🌑,🌑,🌑,🌑,🌑,🌑,🌑,🌑,🌑,🌑,🌑,🌑,🌑,🏕,🌑,🌑,🌑,🌑,🌑,🌑
|🌑,🌑,🌑,🌑,🌑,🌑,🌑,🌑,🌑,🌑,🌑,🌑,🌑,🌑,🌑,🌑,🌑,🌑,🌑,🌑,🌑,🌑,🌑,🌑,🌑,🌑,🌑,🌑,🌑,🌑,🌑,🌑,🌑,🌑,🌑,🌑,🌑,🌑,🌑,🌑,🌑,🌑,🌑,🌑,🌑,🌑,🌑
|🌑,🌑,🌑,🌑,🌑,🌑,🌑,🌑,🌑,🌑,🌑,🌑,🌑,🌑,🌑,🌑,🌑,🌑,🌑,🌑,🌑,🌑,🌑,🌑,🌑,🌑,🌑,🌑,🌑,🌑,🌑,🌑,🌑,🌑,🌑,🌑,🌑,🌑,🌑,🌑,🌑,🌑,🌑,🌑,🌑,🌑,🌑
|🌑,🌑,🌑,🌑,🌑,🌑,🌑,🌑,🌑,🌑,🌑,🌑,🌑,🌑,🌑,🌑,🌑,🌑,🌑,🌑,🌑,🌑,🌑,🌑,🌑,🌑,🌑,🌑,🌑,🌑,🌑,🌑,🌑,🌑,🌑,🌑,🌑,🌑,🌑,🌑,🌑,🌑,🌑,🌑,🌑,🌑,🌑
|🌑,🌑,🌑,🌑,🌑,🌑,🌑,🌑,🌑,🌑,🌑,🌑,🌑,🌑,🌑,🌑,🌑,🌑,🌑,🌑,🌑,🌑,🌑,🌑,🌑,🌑,🌑,🌑,🌑,🌑,🌑,🌑,🌑,🌑,🌑,🌑,🌑,🌑,🌑,🌑,🌑,🌑,🌑,🌑,🌑,🌑,🌑
|🌑,🌑,🌑,🌑,🌑,🌑,🌑,🌑,🌑,🌑,🌑,🌑,🌑,🌑,🌑,🌑,🌑,🌑,🌑,🌑,🌑,🌑,🌑,🌑,🌑,🌑,🌑,🌑,🌑,🌑,🌑,🌑,🌑,🌑,🌑,🌑,🌑,🌑,🌑,🌑,🌑,🌑,🌑,🌑,🌑,🌑,🌑
|🌑,🌑,🌑,🌑,🌑,🌑,🌑,🌑,🌑,🌑,🌑,🌑,🌑,🌑,🌑,🌑,🌑,🌑,🌑,🌑,🌑,🌑,🌑,🌑,🌑,🌑,🌑,🌑,🌑,🌑,🌑,🌑,🌑,🌑,🌑,🌑,🌑,🌑,🌑,🌑,🌑,🌑,🌑,🌑,🌑,🌑,🌑
|🌑,🌑,🌑,🌑,🌑,🌑,🌑,🌑,🌑,🌑,🌑,🌑,🌑,🌑,🌑,🌑,🌑,🌑,🌑,🌑,🌑,🌑,🌑,🌑,🌑,🌑,🌑,🌑,🌑,🌑,🌑,🌑,🌑,🌑,🌑,🌑,🌑,🌑,🌑,🌑,🌑,🌑,🌑,🌑,🌑,🌑,🌑
|🌑,🌑,🌑,🌑,🌑,🌑,🌑,🌑,🌑,🌑,🌑,🌑,🌑,🌑,🌑,🌑,🌑,🌑,🌑,🌑,🌑,🌑,🌑,🌑,🌑,🌑,🌑,🌑,🌑,🌑,🌑,🌑,🌑,🌑,🌑,🌑,🌑,🌑,🌑,🌑,🌑,🌑,🌑,🌑,🌑,🌑,🌑
|🌑,🌑,🌑,🌑,🌑,🌑,🌑,🌑,🌑,🌑,🌑,🌑,🌑,🌑,🌑,🌑,🌑,🌑,🌑,🌑,🌑,🌑,🌑,🌑,🌑,🌑,🌑,🌑,🌑,🌑,🌑,🌑,🌑,🌑,🌑,🌑,🌑,🌑,🌑,🌑,🌑,🌑,🌑,🌑,🌑,🌑,🌑
|🌑,🌑,🌑,🌑,🌑,🌑,🌑,🌑,🌑,🌑,🌑,🌑,🌑,🌑,🌑,🌑,🌑,🌑,🌑,🌑,🌑,🌑,🌑,🌑,🌑,🌑,🌑,🌑,🌑,🌑,🌑,🌑,🌑,🌑,🌑,🌑,🌑,🌑,🌑,🌑,🌑,🌑,🌑,🌑,🌑,🌑,🌑
|🌑,🌑,🌑,🌑,🌑,🌑,🌑,🌑,🌑,🌑,🌑,🌑,🌑,🌑,🌑,🌑,🌑,🌑,🌑,🌑,🌑,🌑,🌑,🌑,🌑,🌑,🌑,🌑,🌑,🌑,🌑,🌑,🌑,🌑,🌑,🌑,🌑,🌑,🌑,🌑,🌑,🌑,🌑,🌑,🌑,🌑,🌑
|🌑,🌑,🌑,🌑,🌑,🌑,🌑,🌑,🌑,🌑,🌑,🌑,🌑,🌑,🌑,🌑,🌑,🌑,🌑,🌑,🌑,🌑,🌑,🌑,🌑,🌑,🌑,🌑,🌑,🌑,🌑,🌑,🌑,🌑,🌑,🌑,🌑,🌑,🌑,🌑,🌑,🌑,🌑,🌑,🌑,🌑,🌑
|🌑,🌑,🌑,🌑,🌑,🌑,🌑,🌑,🌑,🌑,🌑,🌑,🌑,🌑,🌑,🌑,🌑,🌑,🌑,🌑,🌑,🌑,🌑,🌑,🌑,🌑,🌑,🌑,🌑,🌑,🌑,🌑,🌑,🌑,🌑,🌑,🌑,🌑,🌑,🌑,🌑,🌑,🌑,🌑,🌑,🌑,🌑
|🌑,🌑,🌑,🌑,🌑,🌑,🌑,🌑,🌑,🌑,🌑,🌑,🌑,🌑,🌑,🌑,🌑,🌑,🌑,🌑,🌑,🌑,🌑,🌑,🌑,🌑,🌑,🌑,🌑,🌑,🌑,🌑,🌑,🌑,🌑,🌑,🌑,🌑,🌑,🌑,🌑,🌑,🌑,🌑,🌑,🌑,🌑
|🌑,🌑,🌑,🌑,🌑,🌑,🌑,🌑,🌑,🌑,🌑,🌑,🌑,🌑,🌑,🌑,🌑,🌑,🌑,🌑,🌑,🌑,🌑,🌑,🌑,🌑,🌑,🌑,🌑,🌑,🌑,🌑,🌑,🌑,🌑,🌑,🌑,🌑,🌑,🌑,🌑,🌑,🌑,🌑,🌑,🌑,🌑
|🌑,🌑,🌑,🌑,🌑,🌑,🌑,🌑,🌑,🌑,🌑,🌑,🌑,🌑,🌑,🌑,🌑,🌑,🌑,🌑,🌑,🌑,🌑,🌑,🌑,🌑,🌑,🌑,🌑,🌑,🌑,🌑,🌑,🌑,🌑,🌑,🌑,🌑,🌑,🌑,🌑,🌑,🌑,🌑,🌑,🌑,🌑
|🌑,🌑,🌑,🌑,🌑,🌑,🌑,🌑,🌑,🌑,🌑,🌑,🌑,🌑,🌑,🌑,🌑,🌑,🌑,🌑,🌑,🌑,🌑,🌑,🌑,🌑,🌑,🌑,🌑,🌑,🌑,🌑,🌑,🌑,🌑,🌑,🌑,🌑,🌑,🌑,🌑,🌑,🌑,🌑,🌑,🌑,🌑
|🌑,🌑,🌑,🌑,🌑,🌑,🌑,🌑,🌑,🌑,🌑,🌑,🌑,🌑,🌑,🌑,🌑,🌑,🌑,🌑,🌑,🌑,🌑,🌑,🌑,🌑,🌑,🌑,🌑,🌑,🌑,🌑,🌑,🌑,🌑,🌑,🌑,🌑,🌑,🌑,🌑,🌑,🌑,🌑,🌑,🌑,🌑
|🌑,🌑,🌑,🌑,🌑,🌑,🌑,🌑,🌑,🌑,🌑,🌑,🌑,🌑,🌑,🌑,🌑,🌑,🌑,🌑,🌑,🌑,🌑,🌑,🌑,🌑,🌑,🌑,🌑,🌑,🌑,🌑,🌑,🌑,🌑,🌑,🌑,🌑,🌑,🌑,🌑,🌑,🌑,🌑,🌑,🌑,🌑
|🌋,🌑,🌑,🌑,🌑,🌑,🌑,🌑,🌑,🌑,🌑,🌑,🌑,🌑,🌑,🌑,🌑,🌑,🌑,🌑,🏕,🌑,🌑,🌑,🌑,🌑,🌑,🌑,🌑,🌑,🌑,🌑,🌑,🌑,🌑,🌑,🌑,🌑,🌑,🌑,🏜,🌑,🌑,🌑,🌑,🌑,🌑
|🌑,🌑,🌑,🌑,🌑,🌑,🌑,🌑,🌑,🌑,🌑,🌑,🌑,🌑,🌑,🌑,🌑,🌑,🌑,🌑,🌑,🌑,🌑,🌑,🌑,🌑,🌑,🌑,🌑,🌑,🌑,🌑,🌑,🌑,🌑,🌑,🌑,🌑,🌑,🌑,🌑,🌑,🌑,🌑,🌑,🌑,🌑
|🌑,🌑,🌑,🌑,🌑,🌑,🌑,🌑,🌑,🌑,🌑,🌑,🌑,🌑,🌑,🌑,🌑,🌑,🌑,🌑,🌑,🌑,🌑,🌑,🌑,🌑,🌑,🌑,🌑,🌑,🌑,🌑,🌑,🌑,🌑,🌑,🌑,🌑,🌑,🌑,🌑,🌑,🌑,🌑,🌑,🌑,🌑
|🌑,🌑,🌑,🌑,🌑,🌑,🌑,🌑,🌑,🌑,🌑,🌑,🌑,🌑,🌑,🌑,🌑,🌑,🌑,🌑,🌑,🌑,🌑,🌑,🌑,🌑,🌑,🌑,🌑,🌑,🌑,🌑,🌑,🌑,🌑,🌑,🌑,🌑,🌑,🌑,🌑,🌑,🌑,🌑,🌑,🌑,🌑
|🌑,🌑,🌑,🌑,🌑,🌑,🌑,🌑,🌑,🌑,🌑,🌑,🌑,🌑,🌑,🌑,🌑,🌑,🌑,🌑,🌑,🌑,🌑,🌑,🌑,🌑,🌑,🌑,🌑,🌑,🌑,🌑,🌑,🌑,🌑,🌑,🌑,🌑,🌑,🌑,🌑,🌑,🌑,🌑,🌑,🌑,🌑
|🌑,🌑,🌑,🌑,🌑,🌑,🌑,🌑,🌑,🌑,🌑,🌑,🌑,🌑,🌑,🌑,🌑,🌑,🌑,🌑,🌑,🌑,🌑,🌑,🌑,🌑,🌑,🌑,🌑,🌑,🌑,🌑,🌑,🌑,🌑,🌑,🌑,🌑,🌑,🌑,🌑,🌑,🌑,🌑,🌑,🌑,🌑
|🌑,🌑,🌑,🌑,🌑,🌑,🌑,🌑,🌑,🌑,🌑,🌑,🌑,🌑,🌑,🌑,🌑,🌑,🌑,🌑,🌑,🌑,🌑,🌑,🌑,🌑,🌑,🌑,🌑,🌑,🌑,🌑,🌑,🌑,🌑,🌑,🌑,🌑,🌑,🌑,🌑,🌑,🌑,🌑,🌑,🌑,🌑
|🌑,🌑,🌑,🌑,🌑,🌑,🌑,🌑,🌑,🌑,🌑,🌑,🌑,🌑,🌑,🌑,🌑,🌑,🌑,🌑,🌑,🌑,🌑,🌑,🌑,🌑,🌑,🌑,🌑,🌑,🌑,🌑,🌑,🌑,🌑,🌑,🌑,🌑,🌑,🌑,🌑,🌑,🌑,🌑,🌑,🌑,🌑
|🌑,🌑,🌑,🌑,🌑,🌑,🌑,🌑,🌑,🌑,🌑,🌑,🌑,🌑,🌑,🌑,🌑,🌑,🌑,🌑,🌑,🌑,🌑,🌑,🌑,🌑,🌑,🌑,🌑,🌑,🌑,🌑,🌑,🌑,🌑,🌑,🌑,🌑,🌑,🌑,🌑,🌑,🌑,🌑,🌑,🌑,🌑
|🌑,🌑,🌑,🌑,🌑,🌑,🌑,🌑,🌑,🌑,🌑,🌑,🌑,🌑,🌑,🌑,🌑,🌑,🌑,🌑,🌑,🌑,🌑,🌑,🌑,🌑,🌑,🌑,🌑,🌑,🌑,🌑,🌑,🌑,🌑,🌑,🌑,🌑,🌑,🌑,🌑,🌑,🌑,🌑,🌑,🌑,🌑
|🌑,🌑,🌑,🌑,🌑,🌑,🌑,🌑,🌑,🌑,🌑,🌑,🌑,🌑,🌑,🌑,🌑,🌑,🌑,🌑,🌑,🌑,🌑,🌑,🌑,🌑,🌑,🌑,🌑,🌑,🌑,🌑,🌑,🌑,🌑,🌑,🌑,🌑,🌑,🌑,🌑,🌑,🌑,🌑,🌑,🌑,🌑
|🌑,🌑,🌑,🌑,🌑,🌑,🌑,🌑,🌑,🌑,🌑,🌑,🌑,🌑,🌑,🌑,🌑,🌑,🌑,🌑,🌑,🌑,🌑,🌑,🌑,🌑,🌑,🌑,🌑,🌑,🌑,🌑,🌑,🌑,🌑,🌑,🌑,🌑,🌑,🌑,🌑,🌑,🌑,🌑,🌑,🌑,🌑
|🌑,🌑,🌑,🌑,🌑,🌑,🌑,🌑,🌑,🌑,🌑,🌑,🌑,🌑,🌑,🌑,🌑,🌑,🌑,🌑,🌑,🌑,🌑,🌑,🌑,🌑,🌑,🌑,🌑,🌑,🌑,🌑,🌑,🌑,🌑,🌑,🌑,🌑,🌑,🌑,🌑,🌑,🌑,🌑,🌑,🌑,🌑
|🌑,🌑,🌑,🌑,🌑,🌑,🌑,🌑,🌑,🌑,🌑,🌑,🌑,🌑,🌑,🌑,🌑,🌑,🌑,🌑,🌑,🌑,🌑,🌑,🌑,🌑,🌑,🌑,🌑,🌑,🌑,🌑,🌑,🌑,🌑,🌑,🌑,🌑,🌑,🌑,🌑,🌑,🌑,🌑,🌑,🌑,🌑
|🌑,🌑,🌑,🌑,🌑,🌑,🌑,🌑,🌑,🌑,🌑,🌑,🌑,🌑,🌑,🌑,🌑,🌑,🌑,🌑,🌑,🌑,🌑,🌑,🌑,🌑,🌑,🌑,🌑,🌑,🌑,🌑,🌑,🌑,🌑,🌑,🌑,🌑,🌑,🌑,🌑,🌑,🌑,🌑,🌑,🌑,🌑
|🌑,🌑,🌑,🌑,🌑,🌑,🌑,🌑,🌑,🌑,🌑,🌑,🌑,🌑,🌑,🌑,🌑,🌑,🌑,🌑,🌑,🌑,🌑,🌑,🌑,🌑,🌑,🌑,🌑,🌑,🌑,🌑,🌑,🌑,🌑,🌑,🌑,🌑,🌑,🌑,🌑,🌑,🌑,🌑,🌑,🌑,🌑
|🌑,🌑,🌑,🌑,🌑,🌑,🌑,🌑,🌑,🌑,🌑,🌑,🌑,🌑,🌑,🌑,🌑,🌑,🌑,🌑,🌑,🌑,🌑,🌑,🌑,🌑,🌑,🌑,🌑,🌑,🌑,🌑,🌑,🌑,🌑,🌑,🌑,🌑,🌑,🌑,🌑,🌑,🌑,🌑,🌑,🌑,🌑
|🌑,🌑,🌑,🌑,🌑,🌑,🌑,🌑,🌑,🌑,🌑,🌑,🌑,🌑,🌑,🌑,🌑,🌑,🌑,🌑,🌑,🌑,🌑,🌑,🌑,🌑,🌑,🌑,🌑,🌑,🌑,🌑,🌑,🌑,🌑,🌑,🌑,🌑,🌑,🌑,🌑,🌑,🌑,🌑,🌑,🌑,🌑
|🌑,🌑,🌑,🌑,🌑,🌑,🌑,🌑,🌑,🌑,🌑,🌑,🌑,🌑,🌑,🌑,🌑,🌑,🌑,🌑,🌑,🌑,🌑,🌑,🌑,🌑,🌑,🌑,🌑,🌑,🌑,🌑,🌑,🌑,🌑,🌑,🌑,🌑,🌑,🌑,🌑,🌑,🌑,🌑,🌑,🌑,🌑
|🌑,🌑,🌑,🌑,🌑,🌑,🌑,🌑,🌑,🌑,🌑,🌑,🌑,🌑,🌑,🌑,🌑,🌑,🌑,🌑,🌑,🌑,🌑,🌑,🌑,🌑,🌑,🌑,🌑,🌑,🌑,🌑,🌑,🌑,🌑,🌑,🌑,🌑,🌑,🌑,🌑,🌑,🌑,🌑,🌑,🌑,🌑
|🌵,🌑,🌑,🌑,🌑,🌑,🌑,🌑,🌑,🌑,🌑,🌑,🌑,🌑,🌑,🌑,🌑,🌑,🌑,🌑,🏕,🌑,🌑,🌑,🌑,🌑,🌑,🌑,🌑,🌑,🌑,🌑,🌑,🌑,🌑,🌑,🌑,🌑,🌑,🌑,🌵,🌑,🌑,🌑,🌑,🌑,🌑
|🌑,🌑,🌑,🌑,🌑,🌑,🌑,🌑,🌑,🌑,🌑,🌑,🌑,🌑,🌑,🌑,🌑,🌑,🌑,🌑,🌑,🌑,🌑,🌑,🌑,🌑,🌑,🌑,🌑,🌑,🌑,🌑,🌑,🌑,🌑,🌑,🌑,🌑,🌑,🌑,🌑,🌑,🌑,🌑,🌑,🌑,🌑
|🌑,🌑,🌑,🌑,🌑,🌑,🌑,🌑,🌑,🌑,🌑,🌑,🌑,🌑,🌑,🌑,🌑,🌑,🌑,🌑,🌑,🌑,🌑,🌑,🌑,🌑,🌑,🌑,🌑,🌑,🌑,🌑,🌑,🌑,🌑,🌑,🌑,🌑,🌑,🌑,🌑,🌑,🌑,🌑,🌑,🌑,🌑
|🌑,🌑,🌑,🌑,🌑,🌑,🌑,🌑,🌑,🌑,🌑,🌑,🌑,🌑,🌑,🌑,🌑,🌑,🌑,🌑,🌑,🌑,🌑,🌑,🌑,🌑,🌑,🌑,🌑,🌑,🌑,🌑,🌑,🌑,🌑,🌑,🌑,🌑,🌑,🌑,🌑,🌑,🌑,🌑,🌑,🌑,🌑
|🌑,🌑,🌑,🌑,🌑,🌑,🌑,🌑,🌑,🌑,🌑,🌑,🌑,🌑,🌑,🌑,🌑,🌑,🌑,🌑,🌑,🌑,🌑,🌑,🌑,🌑,🌑,🌑,🌑,🌑,🌑,🌑,🌑,🌑,🌑,🌑,🌑,🌑,🌑,🌑,🌑,🌑,🌑,🌑,🌑,🌑,🌑
|🌑,🌑,🌑,🌑,🌑,🌑,🌑,🌑,🌑,🌑,🌑,🌑,🌑,🌑,🌑,🌑,🌑,🌑,🌑,🌑,🌑,🌑,🌑,🌑,🌑,🌑,🌑,🌑,🌑,🌑,🌑,🌑,🌑,🌑,🌑,🌑,🌑,🌑,🌑,🌑,🌑,🌑,🌑,🌑,🌑,🌑,🌑
|🌑,🌑,🌑,🌑,🌑,🌑,🌑,🌑,🌑,🌑,🌑,🌑,🌑,🌑,🌑,🌑,🌑,🌑,🌑,🌑,🌑,🌑,🌑,🌑,🌑,🌑,🌑,🌑,🌑,🌑,🌑,🌑,🌑,🌑,🌑,🌑,🌑,🌑,🌑,🌑,🌑,🌑,🌑,🌑,🌑,🌑,🌑
|🌑,🌑,🌑,🌑,🌑,🌑,🌑,🌑,🌑,🌑,🌑,🌑,🌑,🌑,🌑,🌑,🌑,🌑,🌑,🌑,🌑,🌑,🌑,🌑,🌑,🌑,🌑,🌑,🌑,🌑,🌑,🌑,🌑,🌑,🌑,🌑,🌑,🌑,🌑,🌑,🌑,🌑,🌑,🌑,🌑,🌑,🌑
|🌑,🌑,🌑,🌑,🌑,🌑,🌑,🌑,🌑,🌑,🌑,🌑,🌑,🌑,🌑,🌑,🌑,🌑,🌑,🌑,🌑,🌑,🌑,🌑,🌑,🌑,🌑,🌑,🌑,🌑,🌑,🌑,🌑,🌑,🌑,🌑,🌑,🌑,🌑,🌑,🌑,🌑,🌑,🌑,🌑,🌑,🌑
|🌑,🌑,🌑,🌑,🌑,🌑,🌑,🌑,🌑,🌑,🌑,🌑,🌑,🌑,🌑,🌑,🌑,🌑,🌑,🌑,🌑,🌑,🌑,🌑,🌑,🌑,🌑,🌑,🌑,🌑,🌑,🌑,🌑,🌑,🌑,🌑,🌑,🌑,🌑,🌑,🌑,🌑,🌑,🌑,🌑,🌑,🌑
|🌑,🌑,🌑,🌑,🌑,🌑,🌑,🌑,🌑,🌑,🌑,🌑,🌑,🌑,🌑,🌑,🌑,🌑,🌑,🌑,🌑,🌑,🌑,🌑,🌑,🌑,🌑,🌑,🌑,🌑,🌑,🌑,🌑,🌑,🌑,🌑,🌑,🌑,🌑,🌑,🌑,🌑,🌑,🌑,🌑,🌑,🌑
|🌑,🌑,🌑,🌑,🌑,🌑,🌑,🌑,🌑,🌑,🌑,🌑,🌑,🌑,🌑,🌑,🌑,🌑,🌑,🌑,🌑,🌑,🌑,🌑,🌑,🌑,🌑,🌑,🌑,🌑,🌑,🌑,🌑,🌑,🌑,🌑,🌑,🌑,🌑,🌑,🌑,🌑,🌑,🌑,🌑,🌑,🌑
|🌑,🌑,🌑,🌑,🌑,🌑,🌑,🌑,🌑,🌑,🌑,🌑,🌑,🌑,🌑,🌑,🌑,🌑,🌑,🌑,🌑,🌑,🌑,🌑,🌑,🌑,🌑,🌑,🌑,🌑,🌑,🌑,🌑,🌑,🌑,🌑,🌑,🌑,🌑,🌑,🌑,🌑,🌑,🌑,🌑,🌑,🌑
|🌑,🌑,🌑,🌑,🌑,🌑,🌑,🌑,🌑,🌑,🌑,🌑,🌑,🌑,🌑,🌑,🌑,🌑,🌑,🌑,🌑,🌑,🌑,🌑,🌑,🌑,🌑,🌑,🌑,🌑,🌑,🌑,🌑,🌑,🌑,🌑,🌑,🌑,🌑,🌑,🌑,🌑,🌑,🌑,🌑,🌑,🌑
|🌑,🌑,🌑,🌑,🌑,🌑,🌑,🌑,🌑,🌑,🌑,🌑,🌑,🌑,🌑,🌑,🌑,🌑,🌑,🌑,🌑,🌑,🌑,🌑,🌑,🌑,🌑,🌑,🌑,🌑,🌑,🌑,🌑,🌑,🌑,🌑,🌑,🌑,🌑,🌑,🌑,🌑,🌑,🌑,🌑,🌑,🌑
|🌑,🌑,🌑,🌑,🌑,🌑,🌑,🌑,🌑,🌑,🌑,🌑,🌑,🌑,🌑,🌑,🌑,🌑,🌑,🌑,🌑,🌑,🌑,🌑,🌑,🌑,🌑,🌑,🌑,🌑,🌑,🌑,🌑,🌑,🌑,🌑,🌑,🌑,🌑,🌑,🌑,🌑,🌑,🌑,🌑,🌑,🌑
|🌑,🌑,🌑,🌑,🌑,🌑,🌑,🌑,🌑,🌑,🌑,🌑,🌑,🌑,🌑,🌑,🌑,🌑,🌑,🌑,🌑,🌑,🌑,🌑,🌑,🌑,🌑,🌑,🌑,🌑,🌑,🌑,🌑,🌑,🌑,🌑,🌑,🌑,🌑,🌑,🌑,🌑,🌑,🌑,🌑,🌑,🌑
|🌑,🌑,🌑,🌑,🌑,🌑,🌑,🌑,🌑,🌑,🌑,🌑,🌑,🌑,🌑,🌑,🌑,🌑,🌑,🌑,🌑,🌑,🌑,🌑,🌑,🌑,🌑,🌑,🌑,🌑,🌑,🌑,🌑,🌑,🌑,🌑,🌑,🌑,🌑,🌑,🌑,🌑,🌑,🌑,🌑,🌑,🌑
|🌑,🌑,🌑,🌑,🌑,🌑,🌑,🌑,🌑,🌑,🌑,🌑,🌑,🌑,🌑,🌑,🌑,🌑,🌑,🌑,🌑,🌑,🌑,🌑,🌑,🌑,🌑,🌑,🌑,🌑,🌑,🌑,🌑,🌑,🌑,🌑,🌑,🌑,🌑,🌑,🌑,🌑,🌑,🌑,🌑,🌑,🌑
|🌑,🌑,🌑,🌑,🌑,🌑,🌑,🌑,🌑,🌑,🌑,🌑,🌑,🌑,🌑,🌑,🌑,🌑,🌑,🌑,🌑,🌑,🌑,🌑,🌑,🌑,🌑,🌑,🌑,🌑,🌑,🌑,🌑,🌑,🌑,🌑,🌑,🌑,🌑,🌑,🌑,🌑,🌑,🌑,🌑,🌑,🌑
|🌋,🌑,🌑,🌑,🌑,🌑,🌑,🌑,🌑,🌑,🌑,🌑,🌑,🌑,🌑,🌑,🌑,🌑,🌑,🌑,🏕,🌑,🌑,🌑,🌑,🌑,🌑,🌑,🌑,🌑,🌑,🌑,🌑,🌑,🌑,🌑,🌑,🌑,🌑,🌑,🌵,🌑,🌑,🌑,🌑,🌑,🌑
|🌑,🌑,🌑,🌑,🌑,🌑,🌑,🌑,🌑,🌑,🌑,🌑,🌑,🌑,🌑,🌑,🌑,🌑,🌑,🌑,🌑,🌑,🌑,🌑,🌑,🌑,🌑,🌑,🌑,🌑,🌑,🌑,🌑,🌑,🌑,🌑,🌑,🌑,🌑,🌑,🌑,🌑,🌑,🌑,🌑,🌑,🌑
|🌑,🌑,🌑,🌑,🌑,🌑,🌑,🌑,🌑,🌑,🌑,🌑,🌑,🌑,🌑,🌑,🌑,🌑,🚹,🚹,🚹,🚹,🚹,🚹,🚹,🚹,🚹,🚹,🚹,🚹,🚹,🚹,🚹,🚹,🚹,🚹,🚹,🚹,🚹,🚹,🚹,🌑,🌑,🌑,🌑,🌑,🌑
|🌑,🌑,🌑,🌑,🌑,🌑,🌑,🌑,🌑,🌑,🌑,🌑,🌑,🌑,🌑,🌑,🌑,🚹,🚹,🚹,🚹,🚹,🚹,🚹,🚹,🚹,🚹,🚹,🚹,🚹,🚹,🚹,🚹,🚹,🚹,🚹,🚹,🚹,🚹,🚹,🚹,🚹,🌑,🌑,🌑,🌑,🌑
|🌑,🌑,🌑,🌑,🌑,🌑,🌑,🌑,🌑,🌑,🌑,🌑,🌑,🌑,🌑,🌑,🌑,🌑,🌑,🌑,🌑,🌑,🌑,🌑,🌑,🌑,🌑,🌑,🌑,🌑,🌑,🌑,🌑,🌑,🌑,🌑,🌑,🌑,🌑,🌑,🌑,🌑,🌑,🌑,🌑,🌑,🌑
|🌑,🌑,🌑,🌑,🌑,🌑,🌑,🌑,🌑,🌑,🌑,🌑,🌑,🌑,🌑,🌑,🌑,🌑,🌑,🌑,🌑,🌑,🌑,🌑,🌑,🌑,🌑,🌑,🌑,🌑,🌑,🌑,🌑,🌑,🌑,🌑,🌑,🌑,🌑,🌑,🌑,🌑,🌑,🌑,🌑,🌑,🌑
|🌑,🌑,🌑,🌑,🌑,🌑,🌑,🌑,🌑,🌑,🌑,🌑,🌑,🌑,🌑,🌑,🌑,🌑,🌑,🌑,🌑,🌑,🔶,🔶,🔶,🔶,🔶,🔶,🌑,🌑,🌑,🌑,🌑,🌑,🌑,🌑,🌑,🌑,🌑,🌑,🌑,🌑,🌑,🌑,🌑,🌑,🌑
|🌑,🌑,🌑,🌑,🌑,🌑,🌑,🌑,🌑,🌑,🌑,🌑,🌑,🌑,🌑,🌑,🌑,🌑,🌑,🌑,🌑,🔶,🔶,🔶,🔶,🔶,🔶,🔶,🔶,🌑,🌑,🌑,🌑,🌑,🌑,🌑,🌑,🌑,🌑,🌑,🌑,🌑,🌑,🌑,🌑,🌑,🌑
|🌑,🌑,🌑,🌑,🌑,🌑,🌑,🌑,🌑,🌑,🌑,🌑,🌑,🌑,🌑,🌑,🌑,🌑,🌑,🌑,🌑,🌑,🔴,🔴,🔴,🔴,🔴,🔴,🌑,🌑,🌑,🌑,🌑,🌑,🌑,🌑,🌑,🌑,🌑,🌑,🌑,🌑,🌑,🌑,🌑,🌑,🌑
|🌑,🌑,🌑,🌑,🌑,🌑,🌑,🌑,🌑,🌑,🌑,🌑,🌑,🌑,🌑,🌑,🌑,🌑,🌑,🌑,🔴,🔴,🌑,🌑,🌑,🌑,🌑,🌑,🔴,🔴,🌑,🌑,🌑,🌑,🌑,🌑,🌑,🌑,🌑,🌑,🌑,🌑,🌑,🌑,🌑,🌑,🌑
|🌑,🌑,🌑,🌑,🌑,🌑,🌑,🌑,🌑,🌑,🌑,🌑,🌑,🌑,🌑,🌑,🌑,🌑,🌑,🌑,🌑,🔴,🌑,🔴,🌑,🔴,🌑,🌑,🔴,🌑,🌑,🌑,🌑,🌑,🌑,🌑,🌑,🌑,🌑,🌑,🌑,🌑,🌑,🌑,🌑,🌑,🌑
|🌑,🌑,🌑,🌑,🌑,🌑,🌑,🌑,🌑,🌑,🌑,🌑,🌑,🌑,🌑,🌑,🌑,🌑,🌑,🌑,🌑,🔴,🌑,🌑,🌑,🌑,🌑,🌑,🔴,🌑,🌑,🌑,🌑,🌑,🌑,🌑,🌑,🌑,🌑,🌑,🌑,🌑,🌑,🌑,🌑,🌑,🌑
|🌑,🌑,🌑,🌑,🌑,🌑,🌑,🌑,🌑,🌑,🌑,🌑,🌑,🌑,🌑,🌑,🌑,🌑,🌑,🌑,🌑,🌑,🔴,🔴,🔴,🔴,🔴,🔴,🌑,🌑,🌑,🌑,🌑,🌑,🌑,🌑,🌑,🌑,🌑,🌑,🌑,🌑,🌑,🌑,🌑,🌑,🌑
|🌑,🌑,🌑,🌑,🌑,🌑,🌑,🌑,🌑,🌑,🌑,🌑,🔶,🌑,🌑,🌑,🌑,🌑,🌑,🌑,🌑,🌑,🌑,🌑,🌑,🌑,🌑,🌑,🌑,🌑,🌑,🌑,🌑,🌑,🌑,🌑,🌑,🌑,🌑,🌑,🌑,🌑,🌑,🌑,🌑,🌑,🌑
|🌑,🌑,🌑,🌑,🌑,🌑,🌑,🌑,🌑,🌑,🔶,🌑,🌑,🌑,🌑,🌑,🌑,🌑,🌑,🌑,🌑,🌑,🌑,🌑,🌑,🌑,🌑,🌑,🌑,🌑,🌑,🌑,🌑,🌑,🌑,🌑,🌑,🌑,🌑,🌑,🌑,🌑,🌑,🌑,🌑,🌑,🌑
|🌑,🌑,🌑,🌑,🌑,🌑,🌑,🌑,🌑,🌑,🌑,🌑,🔴,🌑,🔶,🌑,🌑,🌑,🌑,🌑,🌑,🌑,🌑,🌑,🌑,🌑,🌑,🌑,🌑,🌑,🌑,🌑,🌑,🌑,🌑,🌑,🌑,🌑,🌑,🌑,🌑,🌑,🌑,🌑,🌑,🌑,🌑
|🌑,🌑,🌑,🌑,🌑,🌑,🌑,🌑,🌑,🌑,🌑,🌑,🌑,🌑,🌑,🌑,🌑,🌑,🌑,🌑,🌑,🌑,🌑,🌑,🌑,🌑,🌑,🌑,🌑,🌑,🌑,🌑,🔴,🌑,🌑,🌑,🌑,🌑,🌑,🌑,🌑,🌑,🌑,🌑,🌑,🌑,🌑
|🌑,🌑,🌑,🌑,🌑,🌑,🌑,🌑,🌑,🔴,🌑,🌑,🌑,🌑,🔴,🌑,🌑,🌑,🌑,🌑,🌑,🌑,🌑,🌑,🌑,🌑,🌑,🌑,🌑,🌑,🔴,🌑,🌑,🌑,🌑,🌑,🌑,🌑,🌑,🌑,🌑,🌑,🌑,🌑,🌑,🌑,🌑
|🌑,🌑,🌑,🌑,🌑,🌑,🌑,🌑,🌑,🌑,🌑,🌑,🌑,🌑,🌑,🌑,🌑,🌑,🌑,🌑,🌑,🌑,🌑,🌑,🌑,🌑,🌑,🌑,🌑,🌑,🌑,🌑,🌑,🔴,🌑,🌑,🌑,🌑,🌑,🌑,🌑,🌑,🌑,🌑,🌑,🌑,🌑
|🌑,🌑,🌑,🌑,🌑,🌑,🌑,🌑,🌑,🌑,🌑,🌑,🌑,🌑,🌑,🌑,🌑,🌑,🌑,🌑,🌑,🌑,🌑,🌑,🌑,🌑,🌑,🌑,🌑,🌑,🌑,🔴,🌑,🌑,🌑,🌑,🌑,🌑,🌑,🌑,🌑,🌑,🌑,🌑,🌑,🌑,🌑
|🌵,🌑,🌑,🌑,🌑,🌑,🌑,🌑,🌑,🌑,🌑,🌑,🌑,🌑,🌑,🌑,🌑,🌑,🌑,🌑,🏕,🌑,🌑,🌑,🌑,🌑,🌑,🌑,🌑,🌑,🌑,🌑,🌑,🌑,🌑,🌑,🌑,🌑,🌑,🌑,🌵,🌑,🌑,🌑,🌑,🌑,🌑
|🌑,🌑,🌑,🌑,🌑,🌑,🌑,🌑,🌑,🌑,🌑,🌑,🌑,🌑,🌑,🌑,🌑,🌑,🌑,🌑,🌑,🌑,🌑,🌑,🌑,🌑,🌑,🌑,🌑,🌑,🌑,🌑,🌑,🌑,🌑,🌑,🌑,🌑,🌑,🌑,🌑,🌑,🌑,🌑,🌑,🌑,🌑
|🌑,🌑,🌑,🌑,🌑,🌑,🌑,🌑,🌑,🌑,🌑,🌑,🌑,🌑,🌑,🌑,🌑,🌑,🌑,🌑,🌑,🌑,🌑,🌑,🌑,🌑,🌑,🌑,🌑,🌑,🌑,🌑,🌑,🌑,🌑,🌑,🌑,🌑,🌑,🌑,🌑,🌑,🌑,🌑,🌑,🌑,🌑
|🌑,🌑,🌑,🌑,🌑,🌑,🌑,🌑,🌑,🌑,🌑,🌑,🌑,🌑,🌑,🌑,🌑,🌑,🌑,🌑,🌑,🌑,🌑,🌑,🌑,🌑,🌑,🌑,🌑,🌑,🌑,🌑,🌑,🌑,🌑,🌑,🌑,🌑,🌑,🌑,🌑,🌑,🌑,🌑,🌑,🌑,🌑
|🌑,🌑,🌑,🌑,🌑,🌑,🌑,🌑,🌑,🌑,🌑,🌑,🌑,🌑,🌑,🌑,🌑,🌑,🌑,🌑,🌑,🌑,🌑,🌑,🌑,🌑,🌑,🌑,🌑,🌑,🌑,🌑,🌑,🌑,🌑,🌑,🌑,🌑,🌑,🌑,🌑,🌑,🌑,🌑,🌑,🌑,🌑
|🌑,🌑,🌑,🌑,🌑,🌑,🌑,🌑,🌑,🌑,🌑,🌑,🌑,🌑,🌑,🌑,🌑,🌑,🌑,🌑,🌑,🌑,🌑,🌑,🌑,🌑,🌑,🌑,🌑,🌑,🌑,🌑,🌑,🌑,🌑,🌑,🌑,🌑,🌑,🌑,🌑,🌑,🌑,🌑,🌑,🌑,🌑
|🌑,🌑,🌑,🌑,🌑,🌑,🌑,🌑,🌑,🌑,🌑,🌑,🌑,🌑,🌑,🌑,🌑,🌑,🌑,🌑,🌑,🌑,🌑,🌑,🌑,🌑,🌑,🌑,🌑,🌑,🌑,🌑,🌑,🌑,🌑,🌑,🌑,🌑,🌑,🌑,🌑,🌑,🌑,🌑,🌑,🌑,🌑
|🌑,🌑,🌑,🌑,🌑,🌑,🌑,🌑,🌑,🌑,🌑,🌑,🌑,🌑,🌑,🌑,🌑,🌑,🌑,🌑,🌑,🌑,🌑,🌑,🌑,🌑,🌑,🌑,🌑,🌑,🌑,🌑,🌑,🌑,🌑,🌑,🌑,🌑,🌑,🌑,🌑,🌑,🌑,🌑,🌑,🌑,🌑
|🌑,🌑,🌑,🌑,🌑,🌑,🌑,🌑,🌑,🌑,🌑,🌑,🌑,🌑,🌑,🌑,🌑,🌑,🌑,🌑,🌑,🌑,🌑,🌑,🌑,🌑,🌑,🌑,🌑,🚹,🚹,🌑,🌑,🌑,🌑,🌑,🌑,🌑,🌑,🌑,🌑,🌑,🌑,🌑,🌑,🌑,🌑
|🌑,🌑,🌑,🌑,🌑,🌑,🌑,🌑,🌑,🌑,🌑,🌑,🌑,🌑,🌑,🌑,🌑,🌑,🌑,🌑,🌑,🌑,🌑,🌑,🌑,🌑,🌑,🌑,🌑,🚹,🚹,🌑,🌑,🌑,🌑,🌑,🌑,🌑,🌑,🌑,🌑,🌑,🌑,🌑,🌑,🌑,🌑
|🌑,🌑,🌑,🌑,🌑,🌑,🌑,🌑,🌑,🌑,🌑,🌑,🌑,🌑,🌑,🌑,🔶,🌑,🌑,🌑,🌑,🌑,🌑,🌑,🌑,🌑,🌑,🌑,🌑,🚹,🚹,🌑,🌑,🌑,🌑,🌑,🌑,🌑,🌑,🌑,🌑,🌑,🌑,🌑,🌑,🌑,🌑
|🌑,🌑,🌑,🌑,🌑,🌑,🌑,🌑,🌑,🌑,🌑,🌑,🌑,🌑,🌑,🔴,🔴,🔴,🌑,🌑,🌑,🌑,🌑,🔶,🌑,🌑,🌑,🌑,🌑,🚹,🚹,🌑,🌑,🌑,🌑,🌑,🌑,🌑,🌑,🌑,🌑,🌑,🌑,🌑,🌑,🌑,🌑
|🌑,🌑,🌑,🌑,🌑,🌑,🌑,🌑,🌑,🌑,🌑,🌑,🌑,🌑,🌑,🌑,🌑,🌑,🌑,🌑,🌑,🌑,🔴,🔴,🔴,🌑,🌑,🌑,🌑,🚹,🚹,🌑,🌑,🌑,🌑,🌑,🌑,🌑,🌑,🌑,🌑,🌑,🌑,🌑,🌑,🌑,🌑
|🌑,🌑,🌑,🌑,🌑,🌑,🌑,🌑,🌑,🌑,🌑,🌑,🌑,🌑,🌑,🌑,🌑,🌑,🌑,🌑,🌑,🌑,🔶,🌑,🌑,🌑,🌑,🌑,🌑,🚹,🚹,🌑,🌑,🌑,🌑,🌑,🌑,🌑,🌑,🌑,🌑,🌑,🌑,🌑,🌑,🌑,🌑
|🌑,🌑,🌑,🌑,🌑,🌑,🌑,🌑,🌑,🌑,🌑,🌑,🌑,🌑,🌑,🔶,🔶,🌑,🌑,🌑,🌑,🔴,🔴,🔴,🌑,🌑,🌑,🌑,🌑,🚹,🚹,🌑,🌑,🌑,🌑,🌑,🌑,🌑,🌑,🌑,🌑,🌑,🌑,🌑,🌑,🌑,🌑
|🌑,🌑,🌑,🌑,🌑,🌑,🌑,🌑,🌑,🌑,🌑,🌑,🌑,🌑,🔶,🔴,🔴,🔶,🌑,🌑,🌑,🌑,🌑,🌑,🌑,🌑,🌑,🌑,🌑,🚹,🚹,🌑,🌑,🌑,🌑,🌑,🌑,🌑,🌑,🌑,🌑,🌑,🌑,🌑,🌑,🌑,🌑
|🌑,🌑,🌑,🌑,🌑,🌑,🌑,🌑,🌑,🌑,🌑,🌑,🌑,🌑,🔴,🌑,🌑,🔴,🌑,🌑,🌑,🌑,🌑,🌑,🌑,🌑,🌑,🌑,🌑,🚹,🚹,🌑,🌑,🌑,🌑,🌑,🌑,🌑,🌑,🌑,🌑,🌑,🌑,🌑,🌑,🌑,🌑
|🌑,🌑,🌑,🌑,🌑,🌑,🌑,🌑,🌑,🌑,🌑,🌑,🌑,🌑,🔴,🌑,🌑,🔴,🌑,🌑,🌑,🌑,🌑,🌑,🌑,🔶,🔴,🔴,🌑,🚹,🚹,🌑,🌑,🌑,🌑,🌑,🌑,🌑,🌑,🌑,🌑,🌑,🌑,🌑,🌑,🌑,🌑
|🌑,🌑,🌑,🌑,🌑,🌑,🌑,🌑,🌑,🌑,🌑,🌑,🌑,🌑,🌑,🔴,🔴,🌑,🌑,🌑,🌑,🌑,🌑,🌑,🌑,🔴,🌑,🌑,🔴,🚹,🚹,🌑,🌑,🌑,🌑,🌑,🌑,🌑,🌑,🌑,🌑,🌑,🌑,🌑,🌑,🌑,🌑
|🌑,🌑,🌑,🌑,🌑,🌑,🌑,🌑,🌑,🌑,🌑,🌑,🌑,🌑,🌑,🌑,🌑,🌑,🌑,🌑,🌑,🌑,🌑,🌑,🌑,🔴,🌑,🔶,🔴,🚹,🚹,🌑,🌑,🌑,🌑,🌑,🌑,🌑,🌑,🌑,🌑,🌑,🌑,🌑,🌑,🌑,🌑
|🌋,🌑,🌑,🌑,🌑,🌑,🌑,🌑,🌑,🌑,🌑,🌑,🌑,🌑,🌑,🌑,🌑,🌑,🌑,🌑,🏕,🌑,🌑,🌑,🌑,🌑,🔴,🔴,🌑,🚹,🚹,🌑,🌑,🌑,🌑,🌑,🌑,🌑,🌑,🌑,🌵,🌑,🌑,🌑,🌑,🌑,🌑
|🌑,🌑,🌑,🌑,🌑,🌑,🌑,🌑,🌑,🌑,🌑,🌑,🌑,🌑,🌑,🌑,🌑,🌑,🌑,🌑,🌑,🌑,🌑,🌑,🌑,🌑,🌑,🌑,🌑,🌑,🌑,🌑,🌑,🌑,🌑,🌑,🌑,🌑,🌑,🌑,🌑,🌑,🌑,🌑,🌑,🌑,🌑
|🌑,🌑,🌑,🌑,🌑,🌑,🌑,🌑,🌑,🌑,🌑,🌑,🌑,🌑,🌑,🌑,🌑,🌑,🌑,🌑,🌑,🌑,🌑,🌑,🌑,🌑,🌑,🌑,🌑,🌑,🌑,🌑,🌑,🌑,🌑,🌑,🌑,🌑,🌑,🌑,🌑,🌑,🌑,🌑,🌑,🌑,🌑
|🌑,🌑,🌑,🌑,🌑,🌑,🌑,🌑,🌑,🌑,🌑,🌑,🌑,🌑,🌑,🌑,🌑,🌑,🌑,🌑,🌑,🌑,🌑,🌑,🌑,🌑,🌑,🌑,🌑,🌑,🌑,🌑,🌑,🌑,🌑,🌑,🌑,🌑,🌑,🌑,🌑,🌑,🌑,🌑,🌑,🌑,🌑
|🌑,🌑,🌑,🌑,🌑,🌑,🌑,🌑,🌑,🌑,🌑,🌑,🌑,🌑,🌑,🌑,🌑,🌑,🌑,🌑,🌑,🌑,🌑,🌑,🌑,🌑,🌑,🌑,🌑,🌑,🌑,🌑,🌑,🌑,🌑,🌑,🌑,🌑,🌑,🌑,🌑,🌑,🌑,🌑,🌑,🌑,🌑
|🌑,🌑,🌑,🌑,🌑,🌑,🌑,🌑,🌑,🌑,🌑,🌑,🌑,🌑,🌑,🌑,🌑,🌑,🌑,🌑,🌑,🌑,🌑,🌑,🌑,🌑,🌑,🌑,🌑,🌑,🌑,🌑,🌑,🌑,🌑,🌑,🌑,🌑,🌑,🌑,🌑,🌑,🌑,🌑,🌑,🌑,🌑
|🌑,🌑,🌑,🌑,🌑,🌑,🌑,🌑,🌑,🌑,🌑,🌑,🌑,🌑,🌑,🌑,🌑,🌑,🌑,🌑,🌑,🌑,🌑,🌑,🌑,🌑,🌑,🌑,🌑,🌑,🌑,🌑,🌑,🌑,🌑,🌑,🌑,🌑,🌑,🌑,🌑,🌑,🌑,🌑,🌑,🌑,🌑
|🌑,🌑,🌑,🌑,🌑,🌑,🌑,🌑,🌑,🌑,🌑,🌑,🌑,🌑,🌑,🌑,🌑,🌑,🌑,🌑,🌑,🌑,🌑,🌑,🌑,🌑,🌑,🌑,🌑,🌑,🌑,🌑,🌑,🌑,🌑,🌑,🌑,🌑,🌑,🌑,🌑,🌑,🌑,🌑,🌑,🌑,🌑
|🌑,🌑,🌑,🌑,🌑,🌑,🌑,🌑,🌑,🌑,🌑,🌑,🌑,🌑,🌑,🌑,🌑,🌑,🌑,🌑,🌑,🌑,🌑,🌑,🌑,🌑,🌑,🌑,🌑,🌑,🌑,🌑,🌑,🌑,🌑,🌑,🌑,🌑,🌑,🌑,🌑,🌑,🌑,🌑,🌑,🌑,🌑
|🌑,🌑,🌑,🌑,🌑,🌑,🌑,🌑,🌑,🌑,🌑,🌑,🌑,🌑,🌑,🌑,🌑,🌑,🌑,🌑,🌑,🌑,🌑,🌑,🌑,🌑,🌑,🌑,🌑,🌑,🌑,🌑,🌑,🌑,🌑,🌑,🌑,🌑,🌑,🌑,🌑,🌑,🌑,🌑,🌑,🌑,🌑
|🌑,🌑,🌑,🌑,🌑,🌑,🌑,🌑,🌑,🌑,🌑,🌑,🌑,🌑,🌑,🌑,🌑,🌑,🌑,🌑,🌑,🌑,🌑,🌑,🌑,🌑,🌑,🌑,🌑,🌑,🌑,🌑,🌑,🌑,🌑,🌑,🌑,🌑,🌑,🌑,🌑,🌑,🌑,🌑,🌑,🌑,🌑
|🌑,🌑,🌑,🌑,🌑,🌑,🌑,🌑,🌑,🌑,🌑,🌑,🌑,🌑,🌑,🌑,🌑,🌑,🌑,🌑,🌑,🌑,🌑,🌑,🌑,🌑,🌑,🌑,🌑,🌑,🌑,🌑,🌑,🌑,🌑,🌑,🌑,🌑,🌑,🌑,🌑,🌑,🌑,🌑,🌑,🌑,🌑
|🌑,🌑,🌑,🌑,🌑,🌑,🌑,🌑,🌑,🌑,🌑,🌑,🌑,🌑,🌑,🌑,🌑,🌑,🌑,🌑,🌑,🌑,🌑,🌑,🌑,🌑,🌑,🌑,🌑,🌑,🌑,🌑,🌑,🌑,🌑,🌑,🌑,🌑,🌑,🌑,🌑,🌑,🌑,🌑,🌑,🌑,🌑
|🌑,🌑,🌑,🌑,🌑,🌑,🌑,🌑,🌑,🌑,🌑,🌑,🌑,🌑,🌑,🌑,🌑,🌑,🌑,🌑,🌑,🌑,🌑,🌑,🌑,🌑,🌑,🌑,🌑,🌑,🌑,🌑,🌑,🌑,🌑,🌑,🌑,🌑,🌑,🌑,🌑,🌑,🌑,🌑,🌑,🌑,🌑
|🌑,🌑,🌑,🌑,🌑,🌑,🌑,🌑,🌑,🌑,🌑,🌑,🌑,🌑,🌑,🌑,🌑,🌑,🌑,🌑,🌑,🌑,🌑,🌑,🌑,🌑,🌑,🌑,🌑,🌑,🌑,🌑,🌑,🌑,🌑,🌑,🌑,🌑,🌑,🌑,🌑,🌑,🌑,🌑,🌑,🌑,🌑
|🌑,🌑,🌑,🌑,🌑,🌑,🌑,🌑,🌑,🌑,🌑,🌑,🌑,🌑,🌑,🌑,🌑,🌑,🌑,🌑,🌑,🌑,🌑,🌑,🌑,🌑,🌑,🌑,🌑,🌑,🌑,🌑,🌑,🌑,🌑,🌑,🌑,🌑,🌑,🌑,🌑,🌑,🌑,🌑,🌑,🌑,🌑
|🌑,🌑,🌑,🌑,🌑,🌑,🌑,🌑,🌑,🌑,🌑,🌑,🌑,🌑,🌑,🌑,🌑,🌑,🌑,🌑,🌑,🌑,🌑,🌑,🌑,🌑,🌑,🌑,🌑,🌑,🌑,🌑,🌑,🌑,🌑,🌑,🌑,🌑,🌑,🌑,🌑,🌑,🌑,🌑,🌑,🌑,🌑
|🌑,🌑,🌑,🌑,🌑,🌑,🌑,🌑,🌑,🌑,🌑,🌑,🌑,🌑,🌑,🌑,🌑,🌑,🌑,🌑,🌑,🌑,🌑,🌑,🌑,🌑,🌑,🌑,🌑,🌑,🌑,🌑,🌑,🌑,🌑,🌑,🌑,🌑,🌑,🌑,🌑,🌑,🌑,🌑,🌑,🌑,🌑
|🌑,🌑,🌑,🌑,🌑,🌑,🌑,🌑,🌑,🌑,🌑,🌑,🌑,🌑,🌑,🌑,🌑,🌑,🌑,🌑,🌑,🌑,🌑,🌑,🌑,🌑,🌑,🌑,🌑,🌑,🌑,🌑,🌑,🌑,🌑,🌑,🌑,🌑,🌑,🌑,🌑,🌑,🌑,🌑,🌑,🌑,🌑
|🌑,🌑,🌑,🌑,🌑,🌑,🌑,🌑,🌑,🌑,🌑,🌑,🌑,🌑,🌑,🌑,🌑,🌑,🌑,🌑,🌑,🌑,🌑,🌑,🌑,🌑,🌑,🌑,🌑,🌑,🌑,🌑,🌑,🌑,🌑,🌑,🌑,🌑,🌑,🌑,🌑,🌑,🌑,🌑,🌑,🌑,🌑
|🌵,🌑,🌑,🌑,🌑,🌑,🌑,🌑,🌑,🌑,🌑,🌑,🌑,🌑,🌑,🌑,🌑,🌑,🌑,🌑,🏕,🌑,🌑,🌑,🌑,🌑,🌑,🌑,🌑,🌑,🌑,🌑,🌑,🌑,🌑,🌑,🌑,🌑,🌑,🌑,🌵,🌑,🌑,🌑,🌑,🌑,🌑
|🌑,🌑,🌑,🌑,🌑,🌑,🌑,🌑,🌑,🌑,🌑,🌑,🌑,🌑,🌑,🌑,🌑,🌑,🌑,🌑,🌑,🌑,🌑,🌑,🌑,🌑,🌑,🌑,🌑,🌑,🌑,🌑,🌑,🌑,🌑,🌑,🌑,🌑,🌑,🌑,🌑,🌑,🌑,🌑,🌑,🌑,🌑
|🌑,🌑,🌑,🌑,🌑,🌑,🌑,🌑,🌑,🌑,🌑,🌑,🌑,🌑,🌑,🌑,🌑,🌑,🌑,🌑,🌑,🌑,🌑,🌑,🌑,🌑,🌑,🌑,🌑,🌑,🌑,🌑,🌑,🌑,🌑,🌑,🌑,🌑,🌑,🌑,🌑,🌑,🌑,🌑,🌑,🌑,🌑
|🌑,🌑,🌑,🌑,🌑,🌑,🌑,🌑,🌑,🌑,🌑,🌑,🌑,🌑,🌑,🌑,🌑,🌑,🌑,🌑,🌑,🌑,🌑,🌑,🌑,🌑,🌑,🌑,🌑,🌑,🌑,🌑,🌑,🌑,🌑,🌑,🌑,🌑,🌑,🌑,🌑,🌑,🌑,🌑,🌑,🌑,🌑
|🌑,🌑,🌑,🌑,🌑,🌑,🌑,🌑,🌑,🌑,🌑,🌑,🌑,🌑,🌑,🌑,🌑,🌑,🌑,🌑,🌑,🌑,🌑,🌑,🌑,🌑,🌑,🌑,🌑,🌑,🌑,🌑,🌑,🌑,🌑,🌑,🌑,🌑,🌑,🌑,🌑,🌑,🌑,🌑,🌑,🌑,🌑
|🌑,🌑,🌑,🌑,🌑,🌑,🌑,🌑,🌑,🌑,🌑,🌑,🌑,🌑,🌑,🌑,🌑,🌑,🌑,🌑,🌑,🌑,🌑,🌑,🌑,🌑,🌑,🌑,🌑,🌑,🌑,🌑,🌑,🌑,🌑,🌑,🌑,🌑,🌑,🌑,🌑,🌑,🌑,🌑,🌑,🌑,🌑
|🌑,🌑,🌑,🌑,🌑,🌑,🌑,🌑,🌑,🌑,🌑,🌑,🌑,🌑,🌑,🌑,🌑,🌑,🌑,🌑,🌑,🌑,🌑,🌑,🌑,🌑,🌑,🌑,🌑,🌑,🌑,🌑,🌑,🌑,🌑,🌑,🌑,🌑,🌑,🌑,🌑,🌑,🌑,🌑,🌑,🌑,🌑
|🌑,🌑,🌑,🌑,🌑,🌑,🌑,🌑,🌑,🌑,🌑,🔴,🔴,🔴,🔴,🔴,🔴,🔴,🔴,🔴,🔴,🔴,🔴,🔴,🔴,🔴,🔴,🔴,🔴,🔴,🔴,🔴,🔴,🔴,🔴,🔴,🌑,🌑,🌑,🌑,🌑,🌑,🌑,🌑,🌑,🌑,🌑
|🌑,🌑,🌑,🌑,🌑,🌑,🌑,🌑,🌑,🌑,🌑,❌,❌,❌,❌,❌,❌,❌,❌,❌,❌,❌,❌,❌,❌,❌,❌,❌,❌,❌,❌,❌,❌,❌,🌑,🌑,🌑,🌑,🌑,🌑,🌑,🌑,🌑,🌑,🌑,🌑,🌑
|🌑,🌑,🌑,🌑,🌑,🌑,🌑,🌑,🌑,🌑,🌑,🌑,🌑,☢️,☢️,☢️,☢️,☢️,☢️,☢️,☢️,☢️,☢️,☢️,☢️,☢️,☢️,☢️,☢️,☢️,☢️,☢️,🌑,🌑,🌑,🌑,🌑,🌑,🌑,🌑,🌑,🌑,🌑,🌑,🌑,🌑,🌑
|🌑,🌑,🌑,🌑,🌑,🌑,🌑,🌑,🌑,🌑,🌑,🌑,🌑,🌑,🌑,🌑,🌑,🌑,🌑,🌑,🌑,🌑,🌑,🌑,🌑,🌑,🌑,🌑,🌑,🌑,🌑,🌑,🌑,🌑,🌑,🌑,🌑,🌑,🌑,🌑,🌑,🌑,🌑,🌑,🌑,🌑,🌑
|🌑,🌑,🌑,🌑,🌑,🌑,🌑,🌑,🌑,🌑,🌑,🌑,🌑,🌑,🌑,🌑,🌑,🌑,🌑,🌑,🌑,🌑,🌑,🌑,🌑,🌑,🌑,🌑,🌑,🌑,🌑,🌑,🌑,🌑,🌑,🌑,🌑,🌑,🌑,🌑,🌑,🌑,🌑,🌑,🌑,🌑,🌑
|🌑,🌑,🌑,🌑,🌑,🌑,🌑,🌑,🌑,🌑,🌑,🌑,🌑,🌑,🌑,🌑,🌑,🌑,🌑,🌑,🌑,🌑,🌑,🌑,🌑,🌑,🌑,🌑,🌑,🌑,🌑,🌑,🌑,🌑,🌑,🌑,🌑,🌑,🌑,🌑,🌑,🌑,🌑,🌑,🌑,🌑,🌑
|🌑,🌑,🌑,🌑,🌑,🌑,🌑,🌑,🌑,🌑,🌑,🌑,🌑,🌑,🌑,🌑,🌑,🌑,🌑,🌑,🌑,🌑,🌑,🌑,🌑,🌑,🌑,🌑,🌑,🌑,🌑,🌑,🌑,🌑,🌑,🌑,🌑,🌑,🌑,🌑,🌑,🌑,🌑,🌑,🌑,🌑,🌑
|🌑,🌑,🌑,🌑,🌑,🌑,🌑,🌑,🌑,🌑,🌑,🌑,🌑,🌑,🌑,🌑,🌑,🌑,🌑,🌑,🌑,🌑,🌑,🌑,🌑,🌑,🌑,🌑,🌑,🌑,🌑,🌑,🌑,🌑,🌑,🌑,🌑,🌑,🌑,🌑,🌑,🌑,🌑,🌑,🌑,🌑,🌑
|🌑,🌑,🌑,🌑,🌑,🌑,🌑,🌑,🌑,🌑,🌑,🌑,🌑,🌑,🌑,🌑,🌑,🌑,🌑,🌑,🌑,🌑,🌑,🌑,🌑,🌑,🌑,🌑,🌑,🌑,🌑,🌑,🌑,🌑,🌑,🌑,🌑,🌑,🌑,🌑,🌑,🌑,🌑,🌑,🌑,🌑,🌑
|🌑,🌑,🌑,🌑,🌑,🌑,🌑,🌑,🌑,🌑,🌑,🌑,🌑,🌑,🌑,🌑,🌑,🌑,🌑,🌑,🌑,🌑,🌑,🌑,🌑,🌑,🌑,🌑,🌑,🌑,🌑,🌑,🌑,🌑,🌑,🌑,🌑,🌑,🌑,🌑,🌑,🌑,🌑,🌑,🌑,🌑,🌑
|🌑,🌑,🌑,🌑,🌑,🌑,🌑,🌑,🌑,🌑,🌑,🌑,🌑,🌑,🌑,🌑,🌑,🌑,🌑,🌑,🌑,🌑,🌑,🌑,🌑,🌑,🌑,🌑,🌑,🌑,🌑,🌑,🌑,🌑,🌑,🌑,🌑,🌑,🌑,🌑,🌑,🌑,🌑,🌑,🌑,🌑,🌑
|🌑,🌑,🌑,🌑,🌑,🌑,🌑,🌑,🌑,🌑,🌑,🌑,🌑,🌑,🌑,🌑,🌑,🌑,🌑,🌑,🌑,🌑,🌑,🌑,🌑,🌑,🌑,🌑,🌑,🌑,🌑,🌑,🌑,🌑,🌑,🌑,🌑,🌑,🌑,🌑,🌑,🌑,🌑,🌑,🌑,🌑,🌑
|🌑,🌑,🌑,🌑,🌑,🌑,🌑,🌑,🌑,🌑,🌑,🌑,🌑,🌑,🌑,🌑,🌑,🌑,🌑,🌑,🌑,🌑,🌑,🌑,🌑,🌑,🌑,🌑,🌑,🌑,🌑,🌑,🌑,🌑,🌑,🌑,🌑,🌑,🌑,🌑,🌑,🌑,🌑,🌑,🌑,🌑,🌑
|🗾,🌑,🌑,🌑,🌑,🌑,🌑,🌑,🌑,🌑,🌑,🌑,🌑,🌑,🌑,🌑,🌑,🌑,🌑,🌑,🏕,🌑,🌑,🌑,🌑,🌑,🌑,🌑,🌑,🌑,🌑,🌑,🌑,🌑,🌑,🌑,🌑,🌑,🌑,🌑,🏜,🌑,🌑,🌑,🌑,🌑,🌑
|🌑,🌑,🌑,🌑,🌑,🌑,🌑,🌑,🌑,🌑,🌑,🌑,🌑,🌑,🌑,🌑,🌑,🌑,🌑,🌑,🌑,🌑,🌑,🌑,🌑,🌑,🌑,🌑,🌑,🌑,🌑,🌑,🌑,🌑,🌑,🌑,🌑,🌑,🌑,🌑,🌑,🌑,🌑,🌑,🌑,🌑,🌑
|🌑,🌑,🌑,🌑,🌑,🌑,🌑,🌑,🌑,🌑,🌑,🌑,🌑,🌑,🌑,🌑,🌑,🌑,🌑,🌑,🌑,🌑,🌑,🌑,🌑,🌑,🌑,🌑,🌑,🌑,🌑,🌑,🌑,🌑,🌑,🌑,🌑,🌑,🌑,🌑,🌑,🌑,🌑,🌑,🌑,🌑,🌑
|🌑,🌑,🌑,🌑,🌑,🌑,🌑,🌑,🌑,🌑,🌑,🌑,🌑,🌑,🌑,🌑,🌑,🌑,🌑,🌑,🌑,🌑,🌑,🌑,🌑,🌑,🌑,🌑,🌑,🌑,🌑,🌑,🌑,🌑,🌑,🌑,🌑,🌑,🌑,🌑,🌑,🌑,🌑,🌑,🌑,🌑,🌑
|🌑,🌑,🌑,🌑,🌑,🌑,🌑,🌑,🌑,🌑,🌑,🌑,🌑,🌑,🌑,🌑,🌑,🌑,🌑,🌑,🌑,🌑,🌑,🌑,🌑,🌑,🌑,🌑,🌑,🌑,🌑,🌑,🌑,🌑,🌑,🌑,🌑,🌑,🌑,🌑,🌑,🌑,🌑,🌑,🌑,🌑,🌑
|🌑,🌑,🌑,🌑,🌑,🌑,🌑,🌑,🌑,🌑,🌑,🌑,🌑,🌑,🌑,🌑,🌑,🌑,🌑,🌑,🌑,🌑,🌑,🌑,🌑,🌑,🌑,🌑,🌑,🌑,🌑,🌑,🌑,🌑,🌑,🌑,🌑,🌑,🌑,🌑,🌑,🌑,🌑,🌑,🌑,🌑,🌑
|🌑,🌑,🌑,🌑,🌑,🌑,🌑,🌑,🌑,🌑,🌑,🌑,🌑,🌑,🌑,🌑,🌑,🌑,🌑,🌑,🌑,🌑,🌑,🌑,🌑,🌑,🌑,🌑,🌑,🌑,🌑,🌑,🌑,🌑,🌑,🌑,🌑,🌑,🌑,🌑,🌑,🌑,🌑,🌑,🌑,🌑,🌑
|🌑,🌑,🌑,🌑,🌑,🌑,🌑,🌑,🌑,🌑,🌑,🌑,🌑,🌑,🌑,🌑,🌑,🌑,🌑,🌑,🌑,🌑,🌑,🌑,🌑,🌑,🌑,🌑,🌑,🌑,🌑,🌑,🌑,🌑,🌑,🌑,🌑,🌑,🌑,🌑,🌑,🌑,🌑,🌑,🌑,🌑,🌑
|🌑,🌑,🌑,🌑,🌑,🌑,🌑,🌑,🌑,🌑,🌑,🌑,🌑,🌑,🌑,🌑,🌑,🌑,🌑,🌑,🌑,🌑,🌑,🌑,🌑,🌑,🌑,🌑,🌑,🌑,🌑,🌑,🌑,🌑,🌑,🌑,🌑,🌑,🌑,🌑,🌑,🌑,🌑,🌑,🌑,🌑,🌑
|🌑,🌑,🌑,🌑,🌑,🌑,🌑,🌑,🌑,🌑,🌑,🌑,🌑,🌑,🌑,🌑,🌑,🌑,🌑,🌑,🌑,🌑,🌑,🌑,🌑,🌑,🌑,🌑,🌑,🌑,🌑,🌑,🌑,🌑,🌑,🌑,🌑,🌑,🌑,🌑,🌑,🌑,🌑,🌑,🌑,🌑,🌑
|🌑,🌑,🌑,🌑,🌑,🌑,🌑,🌑,🌑,🌑,🌑,🌑,🌑,🌑,🌑,🌑,🌑,🌑,🌑,🌑,🌑,🌑,🌑,🌑,🌑,🌑,🌑,🌑,🌑,🌑,🌑,🌑,🌑,🌑,🌑,🌑,🌑,🌑,🌑,🌑,🌑,🌑,🌑,🌑,🌑,🌑,🌑
|🌑,🌑,🌑,🌑,🌑,🌑,🌑,🌑,🌑,🌑,🌑,🌑,🌑,🌑,🌑,🌑,🌑,🌑,🌑,🌑,🌑,🌑,🌑,🌑,🌑,🌑,🌑,🌑,🌑,🌑,🌑,🌑,🌑,🌑,🌑,🌑,🌑,🌑,🌑,🌑,🌑,🌑,🌑,🌑,🌑,🌑,🌑
|🌑,🌑,🌑,🌑,🌑,🌑,🌑,🌑,🌑,🌑,🌑,🌑,🌑,🌑,🌑,🌑,🌑,🌑,🌑,🌑,🌑,🌑,🌑,🌑,🌑,🌑,🌑,🌑,🌑,🌑,🌑,🌑,🌑,🌑,🌑,🌑,🌑,🌑,🌑,🌑,🌑,🌑,🌑,🌑,🌑,🌑,🌑
|🌑,🌑,🌑,🌑,🌑,🌑,🌑,🌑,🌑,🌑,🌑,🌑,🌑,🌑,🌑,🌑,🌑,🌑,🌑,🌑,🌑,🌑,🌑,🌑,🌑,🌑,🌑,🌑,🌑,🌑,🌑,🌑,🌑,🌑,🌑,🌑,🌑,🌑,🌑,🌑,🌑,🌑,🌑,🌑,🌑,🌑,🌑
|🌑,🌑,🌑,🌑,🌑,🌑,🌑,🌑,🌑,🌑,🌑,🌑,🌑,🌑,🌑,🌑,🌑,🌑,🌑,🌑,🌑,🌑,🌑,🌑,🌑,🌑,🌑,🌑,🌑,🌑,🌑,🌑,🌑,🌑,🌑,🌑,🌑,🌑,🌑,🌑,🌑,🌑,🌑,🌑,🌑,🌑,🌑
|🌑,🌑,🌑,🌑,🌑,🌑,🌑,🌑,🌑,🌑,🌑,🌑,🌑,🌑,🌑,🌑,🌑,🌑,🌑,🌑,🌑,🌑,🌑,🌑,🌑,🌑,🌑,🌑,🌑,🌑,🌑,🌑,🌑,🌑,🌑,🌑,🌑,🌑,🌑,🌑,🌑,🌑,🌑,🌑,🌑,🌑,🌑
|🌑,🌑,🌑,🌑,🌑,🌑,🌑,🌑,🌑,🌑,🌑,🌑,🌑,🌑,🌑,🌑,🌑,🌑,🌑,🌑,🌑,🌑,🌑,🌑,🌑,🌑,🌑,🌑,🌑,🌑,🌑,🌑,🌑,🌑,🌑,🌑,🌑,🌑,🌑,🌑,🌑,🌑,🌑,🌑,🌑,🌑,🌑
|🌑,🌑,🌑,🌑,🌑,🌑,🌑,🌑,🌑,🌑,🌑,🌑,🌑,🌑,🌑,🌑,🌑,🌑,🌑,🌑,🌑,🌑,🌑,🌑,🌑,🌑,🌑,🌑,🌑,🌑,🌑,🌑,🌑,🌑,🌑,🌑,🌑,🌑,🌑,🌑,🌑,🌑,🌑,🌑,🌑,🌑,🌑
|🔵️,🌑,🌑,🌑,🌑,🌑,🌑,🌑,🌑,🌑,🌑,🌑,🌑,🌑,🌑,🌑,🌑,🌑,🌑,🌑,🌑,🌑,🌑,🌑,🌑,🌑,🌑,🌑,🌑,🌑,🌑,🌑,🔵️,🌑,🌑,🌑,🌑,🌑,🌑,🌑,🌑,🌑,🌑,🌑,🌑,🌑,🌑
|🌑,🌑,🌑,🌑,🌑,🌑,🌑,🌑,🌑,🌑,🌑,🌑,🌑,🌑,🌑,🌑,🌑,🌑,🌑,🌑,🌑,🌑,🌑,🌑,🌑,🌑,🌑,🌑,🌑,🌑,🌑,🌑,🌑,🌑,🌑,🌑,🌑,🌑,🌑,🌑,🌑,🌑,🌑,🌑,🌑,🌑,🌑
|🏕,🌑,🌑,🌑,🌑,🌑,🌑,🌑,🌑,🌑,🌑,🌑,🌑,🌑,🌑,🌑,🌑,🌑,🌑,🌑,🏕,🌑,🌑,🌑,🌑,🌑,🌑,🌑,🌑,🌑,🌑,🌑,🌑,🌑,🌑,🌑,🌑,🌑,🌑,🌑,🗾,🌑,🌑,🌑,🌑,🌑,🌑
|🌑,🌑,🌑,🌑,🌑,🌑,🌑,🌑,🌑,🌑,🌑,🌑,🌑,🌑,🌑,🌑,🌑,🌑,🌑,🌑,🌑,🌑,🌑,🌑,🌑,🌑,🌑,🌑,🌑,🌑,🌑,🌑,🌑,🌑,🌑,🌑,🌑,🌑,🌑,🌑,🌑,🌑,🌑,🌑,🌑,🌑,🌑
|🌑,🌑,🌑,🌑,🌑,🌑,🌑,🌑,🌑,🌑,🌑,🌑,🌑,🌑,🌑,🌑,🌑,🌑,🌑,🌑,🌑,🌑,🌑,🌑,🌑,🌑,🌑,🌑,🌑,🌑,🌑,🌑,🌑,🌑,🌑,🌑,🌑,🌑,🌑,🌑,🌑,🌑,🌑,🌑,🌑,🌑,🌑
|🌑,🌑,🌑,🌑,🌑,🌑,🌑,🌑,🌑,🌑,🌑,🌑,🌑,🌑,🌑,🌑,🌑,🌑,🌑,🌑,🌑,🌑,🌑,🌑,🌑,🌑,🌑,🌑,🛃,🌑,🌑,🌑,🌑,🌑,🌑,🌑,🌑,🌑,🌑,🌑,🌑,🌑,🌑,🌑,🌑,🌑,🌑
|🌑,🌑,🌑,🌑,🌑,🌑,🌑,🌑,🌑,🌑,🌑,🌑,🌑,🌑,🌑,🌑,🌑,🌑,🌑,🌑,🌑,🌑,🌑,🌑,🌑,🛃,🌑,🛃,🌑,🌑,🌑,🌑,🌑,🌑,🌑,🌑,🌑,🌑,🌑,🌑,🌑,🌑,🌑,🌑,🌑,🌑,🌑
|🌑,🌑,🌑,🌑,🌑,🌑,🌑,🌑,🌑,🌑,🌑,🌑,🌑,🌑,🌑,🌑,🌑,🌑,🌑,🌑,🌑,🌑,🌑,🌑,🛃,🛃,🛃,🛃,🌑,🌑,🌑,🌑,🌑,🌑,🌑,🌑,🌑,🌑,🌑,🌑,🌑,🌑,🌑,🌑,🌑,🌑,🌑
|🌑,🌑,🌑,🌑,🌑,🌑,🌑,🌑,🌑,🌑,🌑,🌑,🌑,🌑,🌑,🌑,🌑,🌑,🌑,🌑,🅿️,🌑,🌑,🛃,🛃,🌑,🌑,🛃,🛃,🌑,🌑,🌑,🌑,🌑,🌑,🌑,🌑,🌑,🌑,🌑,🌑,🌑,🌑,🌑,🌑,🌑,🌑
|🌑,🌑,🌑,🌑,🌑,🌑,🌑,🌑,🌑,🌑,🌑,🌑,🌑,🌑,🌑,🌑,🌑,🌑,🌑,🌑,🌑,🌑,🌑,🌑,🛃,🛃,🛃,🛃,🌑,🌑,🌑,🌑,🌑,🌑,🌑,🌑,🌑,🌑,🌑,🌑,🌑,🌑,🌑,🌑,🌑,🌑,🌑
|🌑,🌑,🌑,🌑,🌑,🌑,🌑,🌑,🌑,🌑,🌑,🌑,🌑,🌑,🌑,🌑,🌑,🌑,🌑,🌑,🌑,🌑,🌑,🌑,🌑,🛃,🌑,🌑,🛃,🌑,🌑,🌑,🌑,🌑,🌑,🌑,🌑,🌑,🌑,🌑,🌑,🌑,🌑,🌑,🌑,🌑,🌑
|🌑,🌑,🌑,🌑,🌑,🌑,🌑,🌑,🌑,🌑,🌑,🌑,🌑,🌑,🌑,🌑,🌑,🌑,🌑,🌑,🌑,🌑,🌑,🌑,🌑,🌑,🌑,🌑,🌑,🌑,🌑,🌑,🌑,🌑,🌑,🌑,🌑,🌑,🌑,🌑,🌑,🌑,🌑,🌑,🌑,🌑,🌑
|🌑,🌑,🌑,🌑,🌑,🌑,🌑,🌑,🌑,🌑,🌑,🌑,🌑,🌑,🌑,🌑,🌑,🌑,🌑,🌑,🌑,🌑,🌑,🌑,🌑,🌑,🌑,🌑,🌑,🌑,🌑,🌑,🌑,🌑,🌑,🌑,🌑,🌑,🌑,🌑,🌑,🌑,🌑,🌑,🌑,🌑,🌑
|🌑,🌑,🌑,🌑,🌑,🌑,🌑,🌑,🌑,🌑,🌑,🌑,🌑,🌑,🌑,🌑,🌑,🌑,🌑,🌑,🌑,🌑,🌑,🌑,🌑,🌑,🌑,🌑,🌑,🌑,🌑,🌑,🌑,🌑,🌑,🌑,🌑,🌑,🌑,🌑,🌑,🌑,🌑,🌑,🌑,🌑,🌑
|🌑,🌑,🌑,🌑,🌑,🌑,🌑,🌑,🌑,🌑,🌑,🌑,🌑,🌑,🌑,🌑,🌑,🌑,🌑,🌑,🌑,🌑,🌑,🌑,🌑,🌑,🌑,🌑,🌑,🌑,🌑,🌑,🌑,🌑,🌑,🌑,🌑,🌑,🌑,🌑,🌑,🌑,🌑,🌑,🌑,🌑,🌑
|🌑,🌑,🌑,🌑,🌑,🌑,🌑,🌑,🌑,🌑,🌑,🌑,🌑,🌑,🌑,🌑,🌑,🌑,🌑,🌑,🌑,🌑,🌑,🌑,🌑,🌑,🌑,🌑,🌑,🌑,🌑,🌑,🌑,🌑,🌑,🌑,🌑,🌑,🌑,🌑,🌑,🌑,🌑,🌑,🌑,🌑,🌑
|🌑,🌑,🌑,🌑,🌑,🌑,🌑,🌑,🌑,🌑,🌑,🌑,🌑,🌑,🌑,🌑,🌑,🌑,🌑,🌑,🌑,🌑,🌑,🌑,🌑,🌑,🌑,🌑,🌑,🌑,🌑,🌑,🌑,🌑,🌑,🌑,🌑,🌑,🌑,🌑,🌑,🌑,🌑,🌑,🌑,🌑,🌑
|🌑,🌑,🌑,🌑,🌑,🌑,🌑,🌑,🌑,🌑,🌑,🌑,🌑,🌑,🌑,🌑,🌑,🌑,🌑,🌑,🌑,🌑,🌑,🌑,🌑,🌑,🌑,🌑,🌑,🌑,🌑,🌑,🌑,🌑,🌑,🌑,🌑,🌑,🌑,🌑,🌑,🌑,🌑,🌑,🌑,🌑,🌑
|🌑,🌑,🌑,🌑,🌑,🌑,🌑,🌑,🌑,🌑,🌑,🌑,🌑,🌑,🌑,🌑,🌑,🌑,🌑,🌑,🌑,🌑,🌑,🌑,🌑,🌑,🌑,🌑,🌑,🌑,🌑,🌑,🌑,🌑,🌑,🌑,🌑,🌑,🌑,🌑,🌑,🌑,🌑,🌑,🌑,🌑,🌑
|🌑,🌑,🌑,🌑,🌑,🌑,🌑,🌑,🌑,🌑,🌑,🌑,🌑,🌑,🌑,🌑,🌑,🌑,🌑,🌑,🌑,🌑,🌑,🌑,🌑,🌑,🌑,🌑,🌑,🌑,🌑,🌑,🌑,🌑,🌑,🌑,🌑,🌑,🌑,🌑,🌑,🌑,🌑,🌑,🌑,🌑,🌑
|🌑,🌑,🌑,🌑,🌑,🌑,🌑,🌑,🌑,🌑,🌑,🌑,🌑,🌑,🌑,🌑,🌑,🌑,🌑,🌑,🌑,🌑,🌑,🌑,🌑,🌑,🌑,🌑,🌑,🌑,🌑,🌑,🌑,🌑,🌑,🌑,🌑,🌑,🌑,🌑,🌑,🌑,🌑,🌑,🌑,🌑,🌑
|🌑,🌑,🌑,🌑,🌑,🌑,🌑,🌑,🌑,🌑,🌑,🌑,🌑,🌑,🌑,🌑,🌑,🌑,🌑,🌑,🌑,🌑,🌑,🌑,🌑,🌑,🌑,🌑,🌑,🌑,🌑,🌑,🌑,🌑,🌑,🌑,🌑,🌑,🌑,🌑,🌑,🌑,🌑,🌑,🌑,🌑,🌑
|🏜,🔵️,🌑,🌑,🌑,🌑,🌑,🌑,🌑,🌑,🌑,🌑,🌑,🌑,🌑,🌑,🌑,🌑,🌑,🌑,🌑,🌵,🌑,🌑,🌑,🌑,🌑,🌑,🌑,🌑,🌑,🌑,🔵️,🌑,🌑,🌑,🌑,🌑,🌑,🌑,🌑,🌑,🏜,🌑,🌑,🌑,🚹